AAB.TO	Aberdeen International Inc
AAUC.TO	Allied Gold Corporation
AAV.TO	Advantage Oil & Gas Ltd
ABX.TO	Barrick Gold Corp
AC.TO	Air Canada
ACAA.TO	Arrow Canadian Advantage Alternative Class
ACB.TO	Aurora Cannabis Inc
ACD.TO	Accord Financial
ACQ.TO	Autocanada Inc
ACX.TO	Act Energy Technologies Ltd
ADCO.TO	Adcore Inc
ADEN.TO	Adentra Inc
ADN.TO	Acadian Timber Corp
AEG.TO	Aegis Brands Inc
AEM.TO	Agnico Eagle Mines Ltd
AFN.TO	Ag Growth International Inc
AG.TO	First Majestic Silver Corp
AGG.TO	Evolve CDN Aggrgt Bond Enhd Yld Fund ETF
AGI.TO	Alamos Gold Inc Cls A
AI.TO	Atrium Mortgage Investment Corp
AIDX.TO	Healwell Ai Inc. Class A
AIF.TO	Altus Group Ltd
AIGO.TO	Global X Artificial Intelligence & Techn
AII.TO	Almonty Industries Inc
AIM.TO	Aimia Inc
AKTAF	Akita Drilling Ltd Cl A NV
ALA.TO	AltaGas Ltd
ALC.TO	Algoma Central
ALS.TO	Altius Minerals Corp
ALYA.TO	Alithya Group
AMAX.TO	Hamilton Gold Producer Yld Maximizer ETF
AMC.TO	Arizona Metals Corp
AMHE.TO	Harvest Amazon Enhanced High Inc Shs ETF
AMM.TO	Almaden Minerals Ltd
AMZH.TO	Harvest Amazon High Income Shares ETF (C
AND.TO	Andlauer Healthcare Group Inc
ANRG.TO	Anaergia Inc
AOI.TO	Africa Oil Corp
AOT.TO	Ascot Resources Ltd
APLI.TO	Appili Therapeutics Inc
APS.TO	Aptose Biosciences Inc
AQN.TO	Algonquin Power and Utilities Corp
ARA.TO	Aclara Resources Inc
ARB.TO	Accelerate Arbitrage Fund ETF
ARE.TO	Aecon Group Inc
ARG.TO	Amerigo Resources Ltd
ARIS.TO	Aris Gold Corporation
ARR.TO	Altius Renewable Royalties Corp
ARTI.TO	Evolve Artificial Intelligence Fund
ARX.TO	Arc Resources Ltd
ASCU.TO	Arizona Sonoran Copper Company Inc
ASM.TO	Avino Silver and Gold Mines Ltd
ASND.TO	Ascendant Resources Inc
ASTL.TO	Algoma Steel Group Inc
ATCU.TO	Candente Copper Corp
ATD.TO	Alimentation Couche-Tard Inc.
ATH.TO	Athabasca Oil Corp
ATRL.TO	Snc-Lavalin Group Inc
ATS.TO	Ats Corp
ATSX.TO	Accelerate Enhanced CDN Bm Alt Fund ETF
ATZ.TO	Aritzia Inc
AUMN.TO	Golden Minerals Company
AVCN.TO	Avicanna Inc
AVL.TO	Avalon Advanced Materials Inc
AVNT.TO	Avant Brands Inc
AW.TO	A W Food Services of Canada Inc
AXIS.TO	Axis Auto Finance Inc
AYA.TO	Aya Gold and Silver Inc
BABY.TO	Else Nutrition Holdings Inc
BAM.TO	Brookfield Asset Management Ltd
BANK.TO	Evolve CDN Banks Lifecos Enh Yld Idx ETF
BASE.TO	Evolve Glob Matls Mining Enh Yld Idx ETF
BB.TO	Blackberry Ltd
BBUC.TO	Brookfield Business Corporation
BCE.TO	BCE Inc
BCT.TO	Briacell Therapeutics Corp
BDGI.TO	Badger Infrastructure Solutions Ltd
BDI.TO	Black Diamond Group Ltd
BDIV.TO	Brompton Global Dividend Growth ETF
BDT.TO	Bird Construction Inc
BEPC.TO	Brookfield Renewable Corp
BEPR.TO	Brompton Flaherty & Crumrine Enhanced IN
BESG.TO	Invesco ESG CDN Core Plus Bond ETF
BFIN.TO	Brompton Na Financials Dividend ETF
BGC.TO	Bristol Gate Concentrated CDN Eqty ETF
BGU.TO	Bristol Gate Concentrated US Eqty ETF
BHC.TO	Bausch Health Companies Inc
BIPC.TO	Brookfield Infrastructure Corp
BIR.TO	Birchcliff Energy Ltd
BITF.TO	Bitfarms Ltd
BITI.TO	Betapro Inverse Bitcoin ETF
BK.TO	Canadian Banc Corp
BKCC.TO	GX Equal Weight CDN Bank Cvrd Call ETF
BKCL.TO	GX Enhanced Equal Weight CDN Banks Cvrd Call ETF
BKI.TO	Black Iron Inc
BLCK.TO	First Trust Indxx Innov Trans Proc ETF
BLCO.TO	Bausch Lomb Corporation
BLDP.TO	Ballard Power Systems Inc
BLN.TO	Blackline Safety Corp
BLOV.TO	Brompton Na Low Volatility Dividend ETF
BLX.TO	Boralex Inc
BMAX.TO	Brompton Enhanced Multi Asset Income ETF
BMO.TO	Bank of Montreal
BN.TO	Brookfield Corporation
BNC.TO	Purpose CDN Financial Income Fund ETF
BND.TO	Purpose Tactical Inv Grade Bond ETF
BNE.TO	Bonterra Energy Corp
BNG.TO	Bengal Energy Ltd
BNK.TO	Big Banc Split Corp Cl A
BNKL.TO	GX Enhanced Equal Weight Banks Idx ETF
BNS.TO	Bank of Nova Scotia
BNT.TO	Brookfield Wealth Solutions Ltd
BOND.TO	Evolve Enhanced Yield Bond Fund ETF
BOS.TO	Airboss America J
BPRF.TO	Bf and Crumrine Invest Grade Pref ETF
BR.TO	Big Rock Brewery Inc
BRAG.TO	Bragg Gaming Group Inc
BRE.TO	Bridgemarq Real Estate Services Inc
BREA.TO	Brompton Global Real Assets Dividend ETF
BRMI.TO	Boat Rocker Media Inc
BRY.TO	Bri Chem Corp
BSKT.TO	Manulife Smart Core Bond ETF
BSX.TO	Belo Sun Mining Corp
BTCC.TO	Purpose Bitcoin ETF Currency Hgd
BTCQ.TO	3iQ Coinshares Bitcoin ETF
BTCY.TO	Purpose Bitcoin Yield ETF
BTE.TO	Baytex Energy Corp
BTO.TO	B2Gold Corp
BU.TO	Burcon Nutrascience Corp
BUI.TO	Buhler Ind
BXF.TO	CI 1 To 5 Yr Lad Gov Stp Bd ETF
BYD.TO	Boyd Group Services Inc
BYL.TO	Baylin Technologies Inc
CACB.TO	CIBC Active Invst Grade Corp Bond ETF
CAE.TO	Cae Inc
CAFR.TO	CIBC Act Invst Grade Float Rate Bond ETF
CAGG.TO	CI Yield Enh CDN Agrt Bond ETF
CAGS.TO	CI Yld Enh CDN ST Agg Bd Idx ETF
CALL.TO	Evolve US Banks Enhanced Yield ETF
CANL.TO	GX Enhanced S&P/Tsx 60 Index ETF
CAPG.TO	Capital Group Global Equity Select ETF
CAPI.TO	Capital Group International Equity Select ETF
CAPM.TO	Capital Group Multi-Sector Income Select ETF
CAPW.TO	Capital Group World Bond Select ETF
CARB.TO	GX Carbon Credits ETF
CARS.TO	Evolve Automobile Innovation Idx Hgd ETF
CAS.TO	Cascades Inc
CASH.TO	GX High Interest Savings ETF
CBAL.TO	CI Balanced Asset Allocation ETF
CBCX.TO	CI Galaxy Blockchain ETF
CBGR.TO	CI Balanced Growth Asset Allocation ETF
CBH.TO	Ishares 1-10 Yr Laddered Corp Bond ETF
CBIL.TO	GX 0-3 Month T-Bill ETF
CBIN.TO	CI Balanced Income Asset Allocation ETF
CBND.TO	Manulife Smart Corporate Bond ETF
CBNK.TO	Mulvihill Canadian Bank Enhanced Yield E
CBO.TO	Ishares 1-5Yr Laddered Corp Bond ETF
CBUG.TO	CI Digital Security ETF
CCA.TO	Cogeco Communications Inc
CCBD.TO	CI U.S. Aggregate Bond Covered Call ETF
CCBI.TO	CIBC Canadian Bond Index ETF
CCEI.TO	CIBC Canadian Equity Index ETF
CCM.TO	Canagold Resources Ltd
CCNS.TO	CIBC Conservative Fixed Income Pool ETF
CCNV.TO	CI Conservative Asset Allocation ETF
CCO.TO	Cameco Corp
CCOM.TO	CI Auspice Broad Commodity ETF
CCRE.TO	CIBC Core Fixed Income Pool ETF
CDEF.TO	Manulife Smart Defensive Equity ETF
CDIV.TO	Manulife Smart Dividend ETF
CDLB.TO	CI Doubleline Total Return Bnd US HD ETF
CDNA.TO	CI Bio Revolution ETF
CDR.TO	Condor Energies Inc
CDZ.TO	Ishares S&P TSX CDN Dividend ETF
CEE.TO	Centamin Plc
CEF.TO	Sprott Physical Gold Silver Trust
CEMI.TO	CIBC Emerging Markets Equity Index ETF
CEMX.TO	Cematrix Corporation
CEQT.TO	CI Equity Asset Allocation ETF
CEU.TO	Ces Energy Solutions Corp
CEW.TO	Ishares Equal Weight Banc Lifeco ETF
CF.TO	Canaccord Genuity Group Inc
CFF.TO	Conifex Timber Inc
CFLX.TO	CIBC Flexible Yield ETF Hedged
CFP.TO	Canfor Corp
CFRT.TO	CI Floating Rate Income Fund
CFW.TO	Calfrac Well Services Ltd
CFX.TO	Canfor Pulp Products Inc
CG.TO	Centerra Gold Inc
CGAA.TO	CI Glb Asset Allocation ETF
CGBI.TO	CIBC Global Bond Ex Can Idx ETF
CGDV.TO	CI Global Min Downside Vol Index ETF
CGG.TO	China Gold Int Resources Corp
CGHY.TO	CI Global High Yld Cdt Pvt Pool ETF
CGI.TO	CDN General Inv
CGIN.TO	CI Global Investment Grade ETF
CGL.TO	Ishares Gold Bullion ETF Hdg
CGLO.TO	CIBC Global Growth ETF
CGO.TO	Cogeco Inc Sv
CGR.TO	Ishares Global Real Estate ETF
CGRA.TO	CI Global Real Asset Private Pool ETF
CGRB.TO	CI Global Green Bond Fund ETF
CGRE.TO	CI Global REIT Private Pool ETF
CGRN.TO	CI Gbl Susble Infra Fund ETF
CGRO.TO	CI Growth Asset Allocation ETF
CGX.TO	Cineplex Inc
CGXF.TO	CI Gld Giants Cvr Call ETF
CGY.TO	Calian Group Ltd
CHPS.TO	GX Semiconductor Index ETF
CHR.TO	Chorus Aviation Inc
CIA.TO	Champion Iron Ltd
CIAI.TO	CI Global Artificial Intelligence ETF
CIBR.TO	First Trust Nasdaq Cybersecurity ETF
CIC.TO	CI Can Banks Cov Call Income Class ETF
CIEH.TO	CIBC International Equity Index ETF
CIEI.TO	CIBC International Equity Index ETF
CIEM.TO	CI Emerging Markets Alpha ETF
CIF.TO	Ishares Global Infrastructure Index ETF
CIGI.TO	Colliers International Group Inc
CINF.TO	CI Global Infrastructure Pvt Pool ETF
CINT.TO	CIBC International Equity ETF
CINV.TO	CI Global Alpha Innovation ETF
CIX.TO	CI Financial Corp
CJ.TO	Cardinal Energy Ltd
CJT.TO	Cargojet Inc
CKI.TO	Clarke Inc
CLF.TO	Ishares 1-5 Yr Ladder Govt Bond ETF
CLG.TO	Ishares 1-10 Yr Ladder Govt Bond ETF
CLML.TO	CI Global Climate Leaders Fund ETF
CLS.TO	Celestica Inc Sv
CM.TO	Canadian Imperial Bank of Commerce
CMAG.TO	CI Munro Alt Global Growth Fund
CMAR.TO	CI Marret Alt Absolute Return Bond Fund
CMDO.TO	CI Alternative Diversified Opp ETF
CMEY.TO	CI Marret Alternative Enhanced Yield ETF
CMG.TO	Computer Modelling Group Ltd
CMGG.TO	CI Munro Global Gwth Equity Fund ETF CAD
CMNY.TO	CI Money Market ETF
CMOM.TO	CI US Enhanced Momentum Ind Heg ETF
CMR.TO	Ishares Premium Money Market ETF
CMVX.TO	CI Galaxy Metaverse Index ETF
CNAO.TO	CI Alternative Na Opps Fund ETF
CNCC.TO	GX S&P/Tsx 60 Covered Call ETF
CNCL.TO	GX Enhanced S&P/Tsx 60 Covered Call ETF
CNDX.TO	Global X S&P/Tsx 60 Index ETF Class A Un
CNE.TO	Canacol Energy Ltd
CNL.TO	Collective Mining Ltd
CNQ.TO	Canadian Natural Resources Ltd.
CNR.TO	Canadian National Railway Co.
CNT.TO	Century Global Commodities Corp
COG.TO	Condor Gold Plc
COMM.TO	BMO Global Communications Index ETF
COPP.TO	GX Copper Producers Index ETF
COPR.TO	Coppernico Metals Inc.
CORE.TO	Pimco Canadian Core Bond Fund
COW.TO	Ishares Global Agri Index ETF
CP.TO	Canadian Pacific Kansas City Ltd
CPD.TO	Ishares S&P TSX CDN Pref ETF
CPH.TO	Cipher Pharmaceuticals Inc
CPLS.TO	CIBC Core Plus Fixed Income Pool ETF
CPX.TO	Capital Power Corp
CR.TO	Crew Energy Inc
CRDL.TO	Cardiol Therapeutics Inc
CRED.TO	CI Lawrence Park Alt Invest Grd Crdt ETF
CRON.TO	Cronos Group Inc
CROP.TO	Purpose Credit Opportunities Fund ETF
CRP.TO	Ceres Global Ag Corp
CRRX.TO	Carerx Corp
CRWN.TO	Crown Capital Partners Inc
CS.TO	Capstone Mining Corp
CSAV.TO	CI High Interest Savings ETF
CSBI.TO	CIBC CDN Short Term Bond Index ETF
CSCI.TO	Cosciens Biopharma Inc
CSU.TO	Constellation Software Inc
CTC.TO	Canadian Tire Corp Ltd
CTS.TO	Converge Technology Solutions Corp
CTX.TO	Crescita Therapeutics Inc
CU.TO	Canadian Utilities Ltd Cl A NV
CUBD.TO	CI Global Unconstrained Bond Fund ETF
CUD.TO	Ishares S&P US Div Growers ETF
CUDV.TO	CI U.S. Minimum Downside Volatility Index ETF
CUEH.TO	CIBC US Equity Index ETF
CUEI.TO	CIBC US Equity Index ETF
CURA.TO	Curaleaf Holdings Inc
CUTL.TO	CI Utilities Giants Covered Call ETF
CVD.TO	Ishares Convertible Bond Index ETF
CVE.TO	Cenovus Energy Inc
CVG.TO	Clairvest Group
CVLU.TO	CI US Enhanced Val Indx Heg ETF
CVO.TO	Coveo Solutions Inc
CWB.TO	CDN Western Bank
CWEB.TO	Charlotte's Web Holdings Inc
CWL.TO	Caldwell Partners International Inc
CWW.TO	Ishares S&P Global Water ETF
CXB.TO	Calibre Mining Corp
CXF.TO	CI CDN Convert Bond ETF
CXI.TO	Currency Exchange International Corp
CYB.TO	Cymbria Corp Cl A
CYBR.TO	Evolve Cyber Security Index Hgd ETF
CYH.TO	Ishares Global Monthly Dividend ETF
DAMG.TO	Desjardins Alt Long/Short Global Equity Markets
DANC.TO	Desjardins Lng Shrt Eqty Mkt Ntrl ETF
DATA.TO	Evolve Cloud Computing Index Fund Hg ETF
DAY.TO	Dayforce Inc
DBM.TO	Doman Building Materials Group Ltd.
DBO.TO	Dbox Technologies Inc
DCBC.TO	Desjardins Canadian Corp Bond Index ETF
DCBO.TO	Docebo Inc
DCC.TO	Desjardins 1To5 Yr Lad CDN Corp Bd ETF
DCG.TO	Desjardins 1To5 Yr Lad CDN Govt Bd ETF
DCM.TO	Data Communications Mgmt Corp
DCP.TO	Desjardins CDN Pref Share ETF
DCS.TO	Desjardins CDN Short Term Bd ETF
DCU.TO	Desjardins CDN Universe Bond Index ETF
DF.TO	Dividend 15 Split Corp II
DFN.TO	Dividend 15 Split Corp
DFY.TO	Definity Financial Corporation
DGR.TO	CI Wisdomtree US Qty Div Gwth Idx ETF
DGRC.TO	CI Wisdomtree CDN Qlty Div Grth Idx ETF
DGS.TO	Dividend Growth Split Corp Class A
DIAM.TO	Star Diamond Corp
DISC.TO	BMO Glb Consumer Disc Hgd To CAD ETF
DIV.TO	Diversified Royalty Corp
DIVS.TO	Evolve Active CDN Pref Share ETF
DLCG.TO	Dominion Lending Centres Inc
DLR.TO	GX US Dollar Currency ETF
DMEC.TO	Desjardins Canadian Equity Index ETF
DMEI.TO	Desjardins International Equity Index ETF
DMEU.TO	Desjardins American Equity Index ETF
DML.TO	Denison Mines Corp
DND.TO	Dye & Durham Ltd
DNG.TO	Dynacor Gold Mines Inc
DNTL.TO	Dentalcorp Holdings Ltd
DOL.TO	Dollarama Inc
DOO.TO	Brp Inc
DPM.TO	Dundee Precious Metals Inc
DR.TO	Medical Facilities Corp
DRCU.TO	Desjardins RI Active Canadian Bond-Low C
DRFC.TO	Desjardins RI Cda Multi Low Co2 ETF
DRFD.TO	Desjardins RI Dev Ex USA Ex Cda Co2 ETF
DRFE.TO	Desjardins Emerging Mkts Low Co2 ETF
DRFG.TO	Desjardins Gbl Fossil Fuel Res Free ETF
DRFU.TO	Desjardins RI USA Multi Low Co2 ETF
DRM.TO	Dream Unlimited Corp
DRMC.TO	Desjardins RI Canada-Low Co2 Index ETF
DRMD.TO	Desjardins RI Dev Exusa Exca Low Co2 ETF
DRME.TO	Desjardins RI Emrgng Mkt Low Co2 Idx ETF
DRMU.TO	Desjardins RI USA Low Co2 Index ETF
DRT.TO	Dirtt Environmental Solutions Ltd
DRX.TO	Adf Group Inc Sv
DS.TO	Dividend Select 15 Corp
DSAE.TO	Desjardins Societerra American Eqty ETF
DSG.TO	Descartes Sys
DSV.TO	Discovery Silver Corp
DTOL.TO	D2L Inc
DXAU.TO	Dynamic Active Global Gold ETF
DXB.TO	Dynamic Ishares Act Tactical Bond ETF
DXBC.TO	Dynamic Active Canadian Bond ETF
DXBU.TO	Dynamic Active U.S. Investment Grade Corporate B
DXC.TO	Dyn Ishares Active CDN Div ETF
DXDB.TO	Dynamic Active Discount Bond ETF
DXEM.TO	Dynamic Active Emerging Markets ETF
DXET.TO	Dynamic Active Energy Evolution ETF
DXF.TO	Dynamic Ishares Act Global Fin Ser ETF
DXG.TO	Dyn Ishares Active Global Div ETF
DXGE.TO	Dynamic Actv Glbl Eqty Income ETF
DXIF.TO	Dynamic Active International ETF
DXMO.TO	Dynamic Active Mining Opportunities ETF
DXN.TO	Dynamic Active Global Infrastructure ETF
DXO.TO	Dyn Ishares Act Crossover Bond ETF
DXP.TO	Dyn Ishares Active Pref Shares ETF
DXQ.TO	Dynamic Active Enh Yld Cov Opt ETF
DXR.TO	Dynamic Active Retirement Income+ ETF
DXRE.TO	Dynamic Active Real Estate ETF
DXT.TO	Dexterra Group Inc
DXU.TO	Dyn Ishares Active US Div ETF
DXUS.TO	Dynamic Actv US Eqty ETF
DXV.TO	Dyn Ishares Act Inv Grd Flot Rt ETF
DXW.TO	Dynamic Active Intl Dividend ETF
DXZ.TO	Dynamic Ishares Acitve US Mid Cap ETF
DYA.TO	Dynacert Inc
E.TO	Enterprise Group Inc
EAGR.TO	East Side Games Group
EARN.TO	Evolve Active Global Fixed Income ETF
EBIT.TO	Bitcoin ETF
EBNK.TO	Evolve European Banks Enhanced Yield ETF
ECN.TO	Ecn Capital Corp
ECO.TO	Ecosynthetix Inc
ECOR.TO	Anglo Pacific Group Plc
EDGE.TO	Evolve Innovation Index ETF
EDGF.TO	Brompton European Div Growth ETF
EDR.TO	Endeavour Silver Corp
EDT.TO	Spectral Medical Inc
EDV.TO	Endeavour Mining Corp
EFN.TO	Element Fleet Management Corp
EFR.TO	Energy Fuels Inc
EFX.TO	Enerflex Ltd
EGIF.TO	Exemplar Growth and Income Fund ETF
EGLX.TO	Enthusiast Gaming Holdings Inc
EHE.TO	CI Wisdomtree Europe Hedged Equity Index ETF
EIF.TO	Exchange Income Corp
ELD.TO	Eldorado Gold
ELEF.TO	Silver Elephant Mining Corp
ELF.TO	E-L Financial
ELO.TO	Eloro Resources Ltd
ELR.TO	Eastern Platinum Ltd
ELVA.TO	Electrovaya Inc
EMA.TO	Emera Incorporated
EMAX.TO	Hamilton Energy Yield Maximizer ETF
ENB.TO	Enbridge Inc
ENCC.TO	GX Canadian Oil and Gas Eqty Cvrd Call ETF
ENCL.TO	GX Enhanced CDN Oil & Gas Eqty Cvrd Call ETF
ENGH.TO	Enghouse Systems Ltd
ENS.TO	E Split Corp
EPRX.TO	Eupraxia Pharmaceuticals Inc
EQB.TO	EQB Inc
EQCC.TO	Global X All Eqty Asset Alloc Cvcl ETF
EQCL.TO	GX Enhanced All-Eqty Asset All Cvrd Call ETF
EQL.TO	Invesco S&P 500 Eql Weight Idx ETF
EQLI.TO	Invesco SP 500 Eql Wght Income Advng ETF
EQX.TO	Equinox Gold Corp
EQY.TO	Franklin All-Equity ETF
ERD.TO	Erdene Resource Development Corp
ERO.TO	Ero Copper Corp
ESG.TO	Invesco S&P 500 ESG Index ETF
ESGA.TO	BMO MSCI Canada ESG Leaders Index ETF
ESGB.TO	BMO ESG Corporate Bond Index ETF
ESGC.TO	Invesco SP TSX Composite ESG Index ETF
ESGE.TO	BMO MSCI EAFE ESG Leaders Index ETF
ESGF.TO	BMO ESG US Corp Bnd Hdgd To CAD Idx ETF
ESGG.TO	BMO MSCI Global ESG Leaders Index ETF
ESGH.TO	BMO ESG High Yld US Corp Bond Index ETF
ESGY.TO	BMO MSCI USA ESG Leaders Index ETF
ESI.TO	Ensign Energy Services Inc
ESM.TO	Euro Sun Mining Inc
ESP.TO	Brompton Energy Split Corp. Class A Shares
ESPX.TO	Evolve SP 500 Enhanced Yield Fund
ET.TO	Evertz Technologies Ltd
ETC.TO	Evolve Cryptocurrencies ETF
ETG.TO	Entree Resources Ltd
ETHH.TO	Purpose Ether CAD ETF
ETHI.TO	GX Global Sustainability Leaders Idx ETF
ETHQ.TO	3iQ Coinshares Ether ETF
ETHR.TO	Ether Unhedg ETF
ETHY.TO	Purpose Ether Yield ETF
ETP.TO	First Trust Global Risk Managed Inc ETF
ETSX.TO	Evolve SP Tsx60 Enhanced Yield Fund
EVO.TO	Evovest Global Equity ETF
EVT.TO	Economic Investment
EXE.TO	Extendicare Inc
EXN.TO	Excellon Resources Inc
EXRO.TO	Exro Technologies Inc
FAP.TO	Aberdeen Asia-Pacific Income Invest Ltd
FAR.TO	Foraco International Sa
FBGO.TO	Franklin Brandywine Glbl Sust Act ETF
FBT.TO	First Trust NYSE Arca Biotechnology ETF
FBTC.TO	Fidelity Advantage Bitcoin ETF
FC.TO	Firm Capital Mortgage Inv. Corp
FCCD.TO	Fidelity CDN High Div Index ETF
FCCQ.TO	Fidelity Canadian High Quality Index ETF
FCCV.TO	Fidelity Canadian Value Index ETF
FCEM.TO	Fidelity Emerging Markets Fund
FCGI.TO	Fidelity Global Monthly High Income ETF
FCID.TO	Fidelity Intl High Dividend Index ETF
FCII.TO	Franklin Clearbridge Sust Glbl Act ETF
FCIQ.TO	Fidelity Intl High Quality Index ETF
FCIV.TO	Fidelity International Value Index ETF
FCMI.TO	Fidelity CDN Monthly High Income ETF
FCQH.TO	Fidelity US High Qlty Cur Ntrl Index ETF
FCRR.TO	Fidelity US Div For Rising Rates Idx ETF
FCSI.TO	Franklin Clearbridge Sust Intl Act ETF
FCU.TO	Fission Uranium Corp
FCUD.TO	Fidelity US High Div Index ETF
FCUH.TO	Fidelity US High Div Cur Neu Idx ETF
FCUQ.TO	Fidelity US High Quality Index ETF
FCUV.TO	Fidelity US Value Index ETF
FCVH.TO	Fidelity US Value Currency Neut Idx ETF
FDL.TO	First Trust Morningstar Div Ldrs ETF Hgd
FDN.TO	First Trust Dow Jones Internet ETF
FDY.TO	Faraday Copper Corp
FEC.TO	Frontera Energy Corp
FEME.TO	Forstrong Emerging Markets Equity ETF
FETH.TO	Fidelity Advantage Ether ETF
FF.TO	First Mining Gold Corp
FFH.TO	Fairfax Financial Holdings Ltd
FFN.TO	North American Financial 15 Split Corp
FGB.TO	CI Short Term Govt Bond Class ETF
FGEB.TO	Fidelity Global Equity Plus Balanced Fund
FGEP.TO	Fidelity Global Equity Plus Fund
FGGE.TO	Franklin Global Growth Active ETF
FGO.TO	CI Enhanced Govt Bond ETF
FGOV.TO	Franklin Canadian Government Bond Fund
FGRW.TO	Forstrong Global Growth ETF
FHG.TO	First Trust US Industrials ETF
FHH.TO	First Trust US Health Care ETF
FHI.TO	CI Hlth Care Giant Cov Call ETF
FHIS.TO	Franklin Bissett Ultra Shrt Bnd Actv ETF
FHQ.TO	First Trust US Technology ETF
FIE.TO	Ishares CDN Fin Mthly Income ETF
FIG.TO	CI Investment Grade Bond ETF
FIL.TO	Filo Mining Corp
FINC.TO	Forstrong Global Income ETF
FINO.TO	Franklin Innovation Active ETF
FINT.TO	First Trust Intl Capital Strength ETF
FLCI.TO	Franklin Liberty CDN Invest Grd Corp ETF
FLCP.TO	Franklin Liberty Core Plus Bond ETF
FLDM.TO	Franklin Libertyqt Intl Eqt Index ETF
FLGA.TO	Franklin Liberty Global Agg Bond ETF
FLGD.TO	Franklin Libertyqt Glb Dividend Idx ETF
FLI.TO	CI US Cda Lifeco Covered Call ETF
FLNT.TO	Flint Corp
FLOW.TO	Flow Beverage Corp
FLSD.TO	Franklin Liberty Short Duration Bond ETF
FLUS.TO	Franklin Libertyqt US Eqt Index ETF
FLX.TO	Purpose Glbl Flexible Credit Fnd ETF
FM.TO	First Quantum Minerals Ltd
FMAX.TO	Hamilton US Financials Yld Maximizer ETF
FN.TO	First National Financial Corp
FNV.TO	Franco-Nevada Corp
FOM.TO	Foran Mining Corp
FOOD.TO	Goodfood Market Corp
FORA.TO	Verticalscope Holdings Inc
FOUR.TO	GX Industry 4.0 Index ETF
FPR.TO	CI Preferred Share ETF
FRU.TO	Freehold Royalties Ltd
FRX.TO	Fennec Pharmaceuticals Inc
FSB.TO	CI Enhanced Sh Dur Bond Fund
FSF.TO	CI Global Financial Sector ETF
FSL.TO	First Trust Senior Loan ETF
FST.TO	First Trust CDN Capital Strength ETF
FSV.TO	Firstservice Corp
FSY.TO	Forsys Metals Corp
FSZ.TO	Fiera Capital Corp
FT.TO	Fortune Mnrl J
FTG.TO	Firan Technology Group Corp
FTHI.TO	Fidelity Tactical High Income Fund
FTN.TO	Financial 15 Split Corp
FTS.TO	Fortis Inc
FTT.TO	Finning Intl
FTU.TO	US Financial 15 Split Corp
FURY.TO	Fury Gold Mines Ltd
FVI.TO	Fortuna Silver Mines Inc
FVL.TO	Freegold Ventures Ltd
FWCP.TO	Franklin Western Asset Core Bnd Actv ETF
FXM.TO	CI Morningstar Cda Value Idx ETF
G.TO	Augusta Gold Corp
GATO.TO	Gatos Silver Inc
GAU.TO	Galiano Gold Inc
GBAL.TO	Ishares ESG Balanced ETF
GBT.TO	Bmtc Group Inc
GCBD.TO	Guardian Canadian Bond ETF
GCFE.TO	Guardian Canadian Focused Equity Fund
GCG.TO	Guardian Capital
GCL.TO	Colabor Group Inc
GCNS.TO	Ishares ESG Conservative Balanced ETF
GCSC.TO	Guardian Canadian Sector Controlled Equi
GCTB.TO	Guardian Ultra-Short Canadian T-Bill Fund
GDC.TO	Genesis Land J
GDEP.TO	Guardian Directed Equity Path ETF
GDI.TO	Gdi Integrated Facility Services Inc
GDL.TO	Goodfellow Inc
GDPY.TO	Guardian Directed Premium Yield ETF
GDV.TO	Global Dividend Growth Split Corp
GEC.TO	Global Education Communities Corp
GEI.TO	Gibson Energy Inc
GENM.TO	Generation Mining Ltd
GEO.TO	Geodrill Ltd
GEQT.TO	Ishares ESG Equity ETF
GFL.TO	Gfl Environmental Inc
GFP.TO	Greenfirst Forest Products Inc
GFR.TO	Greenfire Resources Ltd.
GGD.TO	Gogold Resources Inc
GGRO.TO	Ishares ESG Growth ETF
GH.TO	Gamehost Inc
GIES.TO	Guardian International Equity Select Fund
GIGC.TO	Guardian Invest Grade Corp Bond Fund ETF
GIL.TO	Gildan Activewear Inc
GIQG.TO	Guardian I3 Global Quality Growth ETF
GIQU.TO	Guardian I3 US Quality Growth Hedg ETF
GIVX.TO	Givex Information Technology Group Ltd
GLCC.TO	GX Gold Producer Equity Cvrd Call ETF
GLO.TO	Global Atomic Corp
GLXY.TO	Galaxy Digital Holdings Ltd
GMIN.TO	G Mining Ventures Corp
GMTN.TO	Gold Mountain Mining Corp
GMX.TO	Globex Mining Enterprises Inc
GOLD.TO	Goldmining Inc
GOOS.TO	Canada Goose Holdings Inc
GPMD.TO	Guardpath Managed Decumulation 2042 ETF
GRA.TO	Nanoxplore Inc
GRC.TO	Gold Springs Resource Corp
GRCC.TO	GX Growth Asset Allocation Cvrd Call ETF
GRID.TO	Tantalus Systems Holding Inc
GRN.TO	Greenlane Renewables Inc
GRNI.TO	BMO Brookfield Gbl Rnwbls Infra Fund ETF
GSY.TO	Goeasy Ltd
GTE.TO	Gran Tierra Energy Inc
GTWO.TO	G2 Goldfields Inc
GUD.TO	Knight Therapeutics Inc
GURU.TO	Guru Organic Energy Corp
GVC.TO	Glacier Media Inc
GWO.TO	Great-West Lifeco Inc
GXE.TO	Gear Energy Ltd
H.TO	Hydro One Ltd
HAB.TO	GX Active Corporate Bond ETF
HAC.TO	GX Seasonal Rotation ETF
HAD.TO	GX Active Canadian Bond ETF
HAF.TO	GX Active Global Fixed Income ETF
HAI.TO	Haivision Systems Inc
HAL.TO	GX Active Canadian Dividend ETF
HAZ.TO	GX Active Global Dividend ETF
HBA.TO	Hamilton Australian Banks Equal-Weight ETF
HBAL.TO	GX Balanced Asset Allocation ETF
HBB.TO	GX Canadian Select Univ Bond Idx Corp Cls ETF
HBD.TO	Betapro Gold Bullion 2X Daily Bear ETF
HBF.TO	Harvest Brand Leaders Plus Income ETF
HBGD.TO	GX Big Data & Hardware Index ETF
HBIE.TO	Harvest Balanced Income and Grth Enh ETF
HBIG.TO	Harvest Balanced Income and Growth ETF
HBIL.TO	Hamilton U.S. T-Bill Yield Maximizer Tm ETF
HBKD.TO	Betapro Eql Weight Cnd Bank 2X Bear ETF
HBKU.TO	Betapro Eql Weight Cnd Bank 2X Bull ETF
HBLK.TO	Blockchain Technologies ETF
HBM.TO	Hudbay Minerals Inc
HBND.TO	Hamilton U.S. Bond Yield Maximizer ETF
HBNK.TO	GX Equal Weight Canadian Banks Index ETF
HBP.TO	Helix Biopharm
HBU.TO	Betapro Gold Bullion 2X Daily Bull ETF
HBUG.TO	GX Cybersecurity Index ETF
HCA.TO	Hamilton Canadian Bank Mean Reversion ETF
HCAL.TO	Hamilton Canadian Bank ETF
HCLN.TO	Harvest Clean Energy ETF
HCON.TO	GX Conservative Asset Allocation ETF
HCRE.TO	GX Equal Weight CDN Reits Idx Corp Cls ETF
HDGE.TO	Accelerate Absolute Return Hdg Fund ETF
HDIF.TO	Harvest Diversified Monthly Income ETF
HDIV.TO	Hamilton Enhanced Multi-Sector Covered Call ETF
HEB.TO	Hamilton CDN Bank Equal Weight Idx ETF
HED.TO	Betapro S&P TSX Cap Engy 2X Dly Bear ETF
HEQL.TO	GX Enhanced All-Equity Asset Allocation ETF
HEQT.TO	GX All-Equity Asset Allocation ETF
HERO.TO	Evolve E Gaming Index ETF
HEU.TO	Betapro S&P TSX Cap Engy 2X Dly Bull ETF
HEWB.TO	GX Equal Weight Canadian Banks Idx Corp ETF
HFD.TO	Betapro S&P TSX Cap Fncl 2X Dly Bear ETF
HFG.TO	Hamilton Global Financials ETF
HFIN.TO	Hamilton Enhanced Canadian Financials Et
HFR.TO	GX Active Ultra-Short Term Invt Grade Bond ETF
HFU.TO	Betapro S&P TSX Cap Fncl 2X Dly Bull ETF
HGD.TO	Betapro CDN Gold Miners 2X Dly Bear ETF
HGGB.TO	GX S&P Green Bond Index ETF
HGGG.TO	Harvest Global Gold Giants Index ETF
HGR.TO	Harvest Global REIT Leaders Income ETF
HGRW.TO	GX Growth Asset Allocation ETF
HGU.TO	Betapro CDN Gold Miners 2X Dly Bull ETF
HGY.TO	GX Gold Yield ETF
HHL.TO	Harvest Healthcare Leaders Income ETF
HHLE.TO	Harvest Healthcare Ldrs Enh Income ETF
HIG.TO	Brompton Global Healthcare Inc & Gth ETF
HIND.TO	Harvest Industrial Leaders Income ETF
HIU.TO	Betapro Sp500 Daily Inverse ETF
HIX.TO	Betapro S&P TSX 60 Daily Inverse ETF
HLF.TO	High Liner
HLIF.TO	Harvest Canadian Equity Income Leaders E
HLIT.TO	GX Lithium Producers Index ETF
HLPR.TO	GX Laddered Canadian Prfd Share Idx Corp ETF
HLS.TO	Hls Therapeutics Inc
HMAX.TO	Hamilton CDN Financial Yld Maximizer ETF
HMMJ.TO	GX Marijuana Life Sciences Index ETF
HMP.TO	GX Active Canadian Municipal Bond ETF
HND.TO	Betapro Nat Gas 2X Daily Bear ETF
HNU.TO	Betapro Nat Gas 2X Daily Bull ETF
HOD.TO	Betapro Crude Oil 2X Daily Bear ETF
HOU.TO	Betapro Crude Oil 2X Daily Bull ETF
HPF.TO	Harvest Energy Leaders Plus Income ETF
HPR.TO	GX Active Preferred Share ETF
HPYM.TO	Harvest Premium Yield 7-10 Year Treasury ETF
HPYT.TO	Harvest Premium Yield Treasury ETF
HQD.TO	Betapro Nasdaq 100 2X Daily Bear ETF
HQU.TO	Betapro Nasdaq 100 2X Daily Bull ETF
HRAA.TO	GX Resolve Adaptive Asset Allctn Corp Cls ETF
HRED.TO	Betapro Eql Wgt CDN REIT 2X Dly Bear ETF
HREU.TO	Betapro Eql Wgt CDN REIT 2X Dly Bull ETF
HRIF.TO	Harvest Diversified Equity Income ETF
HRX.TO	Heroux-Devtek
HSAV.TO	GX Cash Maximizer Corporate Class ETF
HSD.TO	Betapro Sp500 2X Daily Bear ETF
HSH.TO	GX S&P 500 CAD Hedged Index Corp Cls ETF
HSU.TO	Betapro Sp500 2X Daily Bull ETF
HTA.TO	Harvest Tech Achievers Growth & Income ETF
HTAE.TO	Harvest Tech Achievers Enh Inc ETF
HTB.TO	GX US 7-10 Yr Treas Bond Idx Corp Cls ETF
HTL.TO	Hamilton Thorne Ltd
HUBL.TO	Harvest US Bank Leaders Income ETF
HUC.TO	GX Crude Oil ETF
HUG.TO	GX Gold ETF
HULC.TO	GX US Large Cap Index Corp Cls ETF
HUM.TO	Hamilton U.S. Mid/Small-Cap Financials E
HUN.TO	GX Natural Gas ETF
HURA.TO	GX Uranium Index ETF
HUT.TO	Hut 8 Corp
HUTE.TO	Harvest Eql Weight Glb Util Enh Inc ETF
HUTL.TO	Harvest Eql Wght Glb Util Income ETF
HUTS.TO	Hamilton Enhanced Utilities ETF
HUV.TO	Betapro Sp500 VIX ST Ftrs ETF
HUZ.TO	GX Silver ETF
HWO.TO	High Arctic Energy Services Inc
HWX.TO	Headwater Exploration Inc
HXCN.TO	GX S&P/Tsx Capped Composite Idx Corp ETF
HXD.TO	Betapro S&P TSX 60 2X Daily Bear ETF
HXDM.TO	GX Intl Dvlpd Mkts Eqty Idx Corp Cls ETF
HXE.TO	GX S&P/Tsx Capped Energy Idx Corp Cls ETF
HXEM.TO	GX Emerging Markets Equity Idx Corp ETF
HXF.TO	GX S&P/Tsx Capped Financials Idx Corp Cls ETF
HXH.TO	GX Canadian High Div Idx Corp Cls ETF
HXQ.TO	GX Nasdaq-100 Index Corporate Class ETF
HXS.TO	GX S&P 500 Index Corporate Class ETF
HXT.TO	GX S&P/Tsx 60 Index Corporate Cls ETF
HXU.TO	Betapro S&P TSX 60 2X Daily Bull ETF
HXX.TO	GX Europe 50 Index Corporate Class ETF
HYBR.TO	GX Active Hybrid Bond and Prfd Share ETF
HYLD.TO	Hamilton Enhanced U.S. Covered Call ETF
HZD.TO	Betapro Silver 2X Daily Bear ETF
HZU.TO	Betapro Silver 2X Daily Bull ETF
IAG.TO	IA Financial Corp Inc
IAU.TO	I-80 Gold Corp
ICAE.TO	Invesco TSX Canadian Dividend Aristocrats ESG IN
ICCB.TO	Invesco Canadian Core Plus Bond ETF
ICE.TO	Canlan ICE Sports Corp
ICPB.TO	IA Clarington Core Plus Bond Fund
ICTE.TO	Invesco SP TSX Comp ESG Tilt Index ETF
IE.TO	Ivanhoe Electric Inc
IFA.TO	Ifabric Corp
IFC.TO	Intact Financial Corp
IFP.TO	Interfor Corp
IFRF.TO	IA Clarington Floating Rate Income ETF
IGAF.TO	IA Clarington Global Allocation Fund ETF
IGB.TO	Purpose Mngd Duration Invest Bond ETF
IGCF.TO	Pimco Investment Grade Credit Fund
IGEO.TO	IA Clarington Loomis Global Equity Opportunities
IGM.TO	Igm Financial Inc
IIAE.TO	Invesco S&P Intl Dvlp Aristocrats ESG ETF
IICE.TO	Invesco SP Intl Developed ESG ETF
III.TO	Imperial Metals Corp
IIMF.TO	Invesco Intl Dev Dyn Mf Idx ETF
IITE.TO	Invesco SP Intl Develped ESG Tilt ETF
ILGB.TO	IA Clarington Loomis Global Multisector Bond Fun
ILLM.TO	Acuityads Holdings Inc
IMG.TO	Iamgold Corp
IMO.TO	Imperial Oil
IMP.TO	Intermap Tech Corp
INAI.TO	Invesco Morningstar Global Next Gen Ai Index ETF
INCM.TO	Accelerate Diversified Credit Income Fun
INE.TO	Innergex Renewable Energy Inc
INOC.TO	GX Inovestor Canadian Equity Index ETF
IPCO.TO	International Petroleum Corp
IPO.TO	Inplay Oil Corp
IQD.TO	CI Wisdomtree Intl Qlty Divd Growth Index ETF
IS.TO	Infrastructure Dividend Split Corp
ISCB.TO	IA Clarington Strategic Corporate Bond Fund
ISO.TO	Isoenergy Ltd
ISV.TO	Information Services Corp
ITE.TO	I3 Energy Plc
ITH.TO	International Tower Hill Mines Ltd
IUAE.TO	Invesco SP US Div Aristocrt ESG ETF
IUCE.TO	Invesco SP US Total Mkt ESG Idx ETF
IUMF.TO	Invesco Russell 1000 Dyn Mf Idx ETF
IUTE.TO	Invesco SP US Total Mkt ESG Tilt ETF
IVN.TO	Ivanhoe Mines Ltd
IVQ.TO	Invesque Inc CAD
IWBE.TO	Invesco ESG Global Bond ETF
IWEB.TO	IA Wealth Enhanced Bond Pool
IXTE.TO	Invesco SP TSX 60 ESG Tilt Index ETF
JAG.TO	Jaguar Mining Inc
JAPN.TO	CI Wisdomtree Japan Equity Index ETF
JEPI.TO	Jpmorgan US Equity Premium Income Active
JEPQ.TO	Jpmorgan Nasdaq Equity Premium Income AC
JOY.TO	Journey Energy Inc
JWEL.TO	Jamieson Wellness Inc
K.TO	Kinross Gold Corp
KBL.TO	Kbro Linen Inc
KEC.TO	Kiwetinohk Energy Corp
KEI.TO	Kolibri Global Energy Inc
KEL.TO	Kelt Exploration Ltd
KEY.TO	Keyera Corp
KILO.TO	Purp Gold Bullion Tu
KITS.TO	Kits Eyecare Ltd
KLS.TO	Kelso Technologies Inc
KNGC.TO	Brompton Canadian Cash Flow Kings ETF
KNGU.TO	Brompton US Cash Flow Kings ETF
KNGX.TO	Brompton Intl Cash Flow Kings ETF
KNT.TO	K92 Mining Inc
KPT.TO	Kp Tissue Inc
KRN.TO	Karnalyte Resources Inc
KSI.TO	Kneat.com Inc
KXS.TO	Kinaxis Inc
L.TO	Loblaw CO
LAAC.TO	Lithium Americas Argentina Corp
LABS.TO	Medipharm Labs Corp
LAC.TO	Lithium Americas Corp
LAM.TO	Laramide Resources Ltd
LB.TO	Laurentian Bank
LBS.TO	Life & Banc Split Corp
LCFS.TO	Tidewater Renewables Ltd
LCS.TO	Brompton Lifeco Split Corp Class A
LEAD.TO	Evolve Future Leadership ETF Hedged
LEV.TO	Lion Electric CO [The]
LFE.TO	Canadian Life Companies Split Corp
LGD.TO	Liberty Gold Corp
LGO.TO	Largo Resources Ltd
LIF.TO	Labrador Iron Ore Royalty Corp
LIFE.TO	Evolve Global Healthcare Enhance Yld ETF
LIRC.TO	Lithium Royalty Corp WI
LLHE.TO	Harvest Eli Lilly Enhanced High Income S
LLYH.TO	Harvest Eli Lilly High Income Shares ETF
LMAX.TO	Hamilton Healthcare Yield Maximizer ETF
LN.TO	Loncor Gold Inc
LNF.TO	Leons Furniture
LNR.TO	Linamar Corp
LONG.TO	CI Global Longevity Economy Fund ETF
LPAY.TO	GX Long-Term U.S. Treasury Prem Yld ETF
LSPD.TO	Lightspeed Commerce Inc.
LSPK.TO	Lifespeak Inc
LUC.TO	Lucara Diamond Corp
LUG.TO	Lundin Gold Inc
LUN.TO	Lundin Mining Corp
LYCT.TO	Lysander Canso Corp Treasury Activ ETF
LYFR.TO	Lysander-Canso Floating Rate Activetf
MAG.TO	MAG Silver Corp
MAL.TO	Magellan Aero
MARI.TO	Marimaca Copper Corp
MATR.TO	Mattr Corp
MBAL.TO	Mackenzie Balanced Allocation ETF
MBX.TO	Microbix J
MCAD.TO	Premium Cash Management Fund ETF
MCB.TO	Mccoy Global Inc
MCLC.TO	Manulife Mltfactor CDN Large Cap Uh ETF
MCLV.TO	Mackenzie Canada Low Volatility ETF
MCON.TO	Mackenzie Conservative Allocation CAD ETF
MCSB.TO	Mackenzie CDN Short Term Fixed Inc ETF
MCSM.TO	Manulife Mulfact CDN Smid Cap Idx ETF
MDA.TO	Mda Ltd
MDI.TO	Major Drilling Grp
MDIV.TO	Middlefield Sustainable Global Dividend
MDNA.TO	Medicenna Therapeutics Corp
MDP.TO	Medexus Pharmaceuticals Inc
MDVD.TO	Mackenzie Global Sustainable Div Idx ETF
MEE.TO	Mackenzie Max Diverse Emg Mkts ETF
MEG.TO	Meg Energy Corp
MEQ.TO	Mainstreet Eq J
MEQT.TO	Mackenzie All Equity Allocation ETF
MFC.TO	Manulife Fin
MFI.TO	Maple Leaf Foods
MFT.TO	Mackenzie Floating Rate Income ETF
MG.TO	Magna International Inc
MGA.TO	Mega Uranium Ltd
MGAB.TO	Mackenzie Global Fixed Income Alloc ETF
MGB.TO	Mackenzie Core Pls Glob Fixed Inc ETF
MGDV.TO	Mackenzie Global Dividend ETF
MGQE.TO	Mackenzie Global Equity ETF
MGRW.TO	Mackenzie Growth Allocation ETF
MHCD.TO	Middlefield Healthcare Dividend ETF
MIN.TO	Excelsior Mining Corp
MINF.TO	Middlefield Sustainable Infrastructure D
MINN.TO	Middlefield Innovation Dividend ETF
MINT.TO	Manulife Mltfactor Dev Intl Hgd ETF
MIQE.TO	Mackenzie International Equity ETF
MIVG.TO	Mackenzie Ivy Global Equity ETF
MKB.TO	Mackenzie Core Pls CDN Fixed Income ETF
MKP.TO	Mcan Mortgage Corp
MND.TO	Mandalay Resources Corp
MNO.TO	Meridian Mining UK Societas
MNS.TO	Royal CDN Mint CDN Silver Reserves Etr
MNT.TO	Royal Canadian Mint CDN Gold Reserves
MNXT.TO	Mackenzie Bluewater Next Gen Grwth ETF
MNY.TO	Purpose Cash Management Fund ETF
MOGO.TO	Mogo Inc
MORE.TO	Mackenzie Core Resources ETF
MPAY.TO	GX Mid-Term U.S. Treasury Prem Yld ETF
MPC.TO	Madison Pac Cl B
MPVD.TO	Mountain Province Diamonds Inc
MPY.TO	Mulvihill Premium Yield Fund ETF
MRC.TO	Morguard Corp
MRD.TO	Melcor Dev
MRE.TO	Martinrea International Inc
MREL.TO	Middlefield Real Estate Dividend ETF
MRU.TO	Metro Inc
MSA.TO	Mineros S.A.
MSCL.TO	Satellos Bioscience Inc
MSFH.TO	Harvest Microsoft High Income Shares ETF
MSHE.TO	Harvest Microsoft Enhanced High Income S
MSV.TO	Minco Silver Corp
MTAV.TO	GX Metaverse Index ETF
MTL.TO	Mullen Group Ltd
MTY.TO	Mty Food Group Inc
MUB.TO	Mackenzie Unconstrained Bond ETF
MULC.TO	Manulife Mltfactor US Large Cap Hgd ETF
MULV.TO	Mackenzie US Low Volatility ETF
MUMC.TO	Manulife Mltfactor US Mid Cap Hgd ETF
MUS.TO	Mackenzie Max Dvrs US Index ETF
MUSA.TO	Middlefield U.S. Equity Dividend ETF
MUSC.TO	Manulife Multifactor U.S. Small Cap Index ETF
MUX.TO	Mcewen Mining Inc
MWD.TO	Mackenzie Max Diversif World Dev ETF
MWLV.TO	Mackenzie World Low Volatility ETF
MX.TO	Methanex Corp
MXG.TO	Maxim Power Corp
MXU.TO	Mackenzie Max Divers Wrld Dev Ex Na ETF
NA.TO	National Bank of Canada
NALT.TO	NBI Liquid Alternatives ETF
NANO.TO	Nano One Materials Corp
NCF.TO	Northcliff Resources Ltd
NCP.TO	Nickel Creek Platinum Corp
NDIV.TO	NBI Canadian Dividend Income ETF
NDM.TO	Northern Dynasty Minerals Ltd
NEO.TO	NEO Performance Materials Inc
NEXT.TO	Nextsource Materials Inc
NFAM.TO	NBI Canadian Family Business ETF
NFI.TO	Nfi Group Inc.
NG.TO	Novagold Res Inc
NGD.TO	New Gold Inc
NGEX.TO	Ngex Minerals Ltd
NGPE.TO	NBI Global Private Equity ETF
NGT.TO	Newmont Corp
NHYB.TO	NBI High Yield Bond ETF
NINT.TO	NBI Active International Equity ETF
NOA.TO	North American Construction Group Ltd
NOVC.TO	Nova Cannabis Inc
NPI.TO	Northland Power Inc
NPK.TO	Verde Agritech Plc
NPRF.TO	NBI Active Canadian Preferred Sh ETF
NPS.TO	Canadian Large Cap Leaders Split Corp
NREA.TO	NBI Global Real Assets Income ETF
NSCB.TO	NBI Sustainable Canadian Bond ETF
NSCC.TO	NBI Sustainable CDN Corporate Bond ETF
NSCE.TO	NBI Sustainable Canadian Equity ETF
NSGE.TO	NBI Sustainable Global Equity ETF
NSSB.TO	NBI Sustainable CDN Short Term Bond ETF
NTR.TO	Nutrien Ltd
NUAG.TO	New Pacific Metals Corp
NUBF.TO	NBI Unconstrained Fixed Income ETF
NUMI.TO	Numinus Wellness Inc
NUSA.TO	NBI Active US Equity ETF
NVA.TO	Nuvista Energy Ltd
NVDH.TO	Harvest Nvidia High Income Shares ETF (C
NVEI.TO	Nuvei Corp
NVHE.TO	Harvest Nvidia Enhanced High Income Shar
NVO.TO	Novo Resources Corp
NWC.TO	The North West Company Inc
NXE.TO	Nexgen Energy Ltd
NXF.TO	CI Energy Giants Cov Call ETF
NXTG.TO	First Trust Indxx Nextg ETF
OBE.TO	Obsidian Energy Ltd
OGC.TO	Oceanagold Corp
OGD.TO	Orbit Garant Drilling Inc
OGI.TO	Organigram Holdings Inc
OLA.TO	Orla Mining Ltd
OLY.TO	Olympia Financial Group Inc
ONC.TO	Oncolytics Bio
ONEB.TO	CI One North American Core Plus Bond ETF
ONEC.TO	Accelerate Onechoice Altnv Portfolio ETF
ONEQ.TO	CI One Global Equity ETF
ONEX.TO	Onex Corp
OPT.TO	Optiva Inc
OR.TO	Osisko Gold Royalties Ltd
ORA.TO	Aura Minerals Inc
ORE.TO	Orezone Gold Corp
ORV.TO	Orvana Minerals J
OSK.TO	Osisko Mining Inc
OTEX.TO	Open Text Corp
OVV.TO	Ovintiv Inc
PAAS.TO	Pan American Silver Corp
PABF.TO	Purpose Actv Balanced Fund ETF
PACF.TO	Purpose Actv Conservative Fund ETF
PAGF.TO	Purpose Actv Growth Fund ETF
PAY.TO	Payfare Inc
PAYF.TO	Purpose Enhanced Premium Yield Fund ETF
PAYS.TO	Global X Short-Term Government Bond Premium Yiel
PBD.TO	Purpose Total Return Bond Fund ETF
PBH.TO	Premium Brands Holdings Corp
PBI.TO	Purpose Best Ideas Fund ETF
PBL.TO	Pollard Banknote Ltd
PCON.TO	Pimco Managed Conservative Bond Pool ETF
PCOR.TO	Pimco Managed Core Bond Pool ETF
PD.TO	Precision Drilling Corp
PDC.TO	Invesco CDN Div Idx ETF
PDF.TO	Purpose Core Dividend Fund ETF
PDIV.TO	Purpose Enhanced Dividend Fund ETF
PDV.TO	Prime Dividend Corp Cl A
PEA.TO	Pieridae Energy Ltd
PET.TO	Pet Valu Holdings Ltd
PEY.TO	Peyto Exploration and Dvlpmnt Corp
PFAA.TO	Picton Mahoney Fortified Alpha Alt ETF
PFAE.TO	Picton Mahoney Fort Act Ext Alt Fund ETF
PFCB.TO	Picton Mahoney Fortified Core Bond ETF
PFIA.TO	Picton Mahoney Fort Income Alt Fund ETF
PFL.TO	Powershares 1 To 3 Yr Lad Float Rate ETF
PFLS.TO	Picton Mahoney Frt Lng Shrt Alt Fund ETF
PFMN.TO	Picton Mahoney Fort Mkt Neutral Fund ETF
PFMS.TO	Picton Mahoney Multi Strat Alt Fund ETF
PFSS.TO	Picton Mahoney Fort Special Sit Alt Fund
PGIC.TO	Premium Global Income Split Corp
PHR.TO	Purpose Duration Hedged Real Estate ETF
PHW.TO	Purpose Intl Tactical Hedged Equity Fund
PHX.TO	Phx Energy Services Corp
PHYS.TO	Sprott Physical Gold Trust CAD
PID.TO	Purpose Intl Dividend Fund ETF
PIF.TO	Polaris Infrastructure Inc
PIN.TO	Purpose Monthly Income Fund ETF
PINC.TO	Purpose Multi Asset Income Fund
PINV.TO	Purpose Global Innovators Fund
PKI.TO	Parkland Fuel Corp
PLDI.TO	Pimco Low Duration Monthly Inc ETF
PLV.TO	Invesco Low Vol Portfolio ETF
PME.TO	Sentry Select Primary Metals Corp
PMET.TO	Patriot Battery Metals Inc
PMIF.TO	Pimco Monthly Income Fund
PMM.TO	Purpose Multi Strategy Mkt Neutral Fund
PMNT.TO	Pimco Global Short Maturity Fund ETF
PMT.TO	Perpetual Energy Inc
PNE.TO	Pine Cliff Energy Ltd
PNP.TO	Pinetree Capital Ltd
POU.TO	Paramount Resources Ltd
POW.TO	Power Corp of Canada Sv
PPL.TO	Pembina Pipeline Corp
PPLN.TO	Global X Pipeline Energy Service Idx ETF
PPR.TO	Prairie Provident Resources Inc
PPTA.TO	Perpetua Resources Corp
PR.TO	Lysander Slater Pref Share Activ ETF
PRA.TO	Purpose Diversified Real Asset Fund ETF
PRB.TO	Probe Gold Inc
PREF.TO	Quadravest Preferred Split Share ETF
PRL.TO	Propel Holdings Inc
PRM.TO	Big Pharma Split Corp
PRMW.TO	Primo Water Corp
PRN.TO	Profound Medical Corp
PRQ.TO	Petrus Resources Ltd
PRU.TO	Perseus Mining Ltd
PRYM.TO	Prime Mining Corp
PSA.TO	Purpose High Interest Savings ETF
PSB.TO	Invesco 1 To 5 Yrladder Inv Grd Bd ETF
PSD.TO	Pulse Seismic Inc
PSI.TO	Pason Systems Inc
PSK.TO	Prairiesky Royalty Ltd
PSLV.TO	Sprott Physical Silver Trust CAD
PTM.TO	Platinum Group Metals Ltd
PWI.TO	Sustainable Power Infra Split Corp Cl A
PXC.TO	Invesco FTSE RAFI CAD Idx ETF
PXS.TO	Pwrshr FTSE RAFI US Fdamntl ETF II
PXT.TO	Parex Resources Inc
PYF.TO	Purpose Premium Yield Fund ETF
PYR.TO	Pyrogenesis Canada Inc
PZA.TO	Pizza Pizza Royalty Corp
PZW.TO	Pwrshr FTSE RAFI Glb Sml Mid Fdamntl ETF
QAH.TO	Mackenzie US Large Cap Eqty Idx CAD Hgd
QASH.TO	Mackenzie CDN Ultra Short Bond Index ETF
QBB.TO	Mackenzie CDN Aggregate Bond Index ETF
QBTC.TO	The Bitcoin Fund CAD
QBTL.TO	Agfiq US Mkt Neut Antibeta CAD Hdg ETF
QCE.TO	Mackenzie CDN Large Cap Equity Index ETF
QCLN.TO	First Trust Nsdq Cln Edg Green Enrgy ETF
QCN.TO	Mackenzie Canadian Equity Index ETF
QDX.TO	Mackenzie International Equity Index ETF
QDXB.TO	Mackenzie Dev Ex Na Agg Bond Idx Hgd ETF
QDXH.TO	Mackenzie Intl Equity Index ETF CAD Hgd
QEBH.TO	Mackenzie Emerging Mkts Bond Index ETF
QEBL.TO	Mackenzie Emerging Mkts Local Cur Bd ETF
QEC.TO	Questerre Energy Corp
QEE.TO	Mackenzie Emerging Mkts Equity Index ETF
QHY.TO	Mackenzie US High Yld Bnd Idx CAD Hgd
QIE.TO	Quantshrs Enh Core Intl Equity ETF
QINF.TO	Mackenzie Global Infrastructure Indx ETF
QIPT.TO	Quipt Home Medical Corp
QLB.TO	Mackenzie CDN Govt Long Bond Index ETF
QMAX.TO	Hamilton Technology Yield Maximizer ETF
QQC.TO	Invesco Nasdaq 100 Index ETF
QQCC.TO	GX Nasdaq-100 Covered Call ETF
QQCE.TO	Invesco ESG Nasdaq 100 Idx ETF
QQCI.TO	Invesco Nasdaq 100 Income Advantage ETF
QQCL.TO	GX Enhanced Nasdaq-100 Covered Call ETF
QQEQ.TO	Invesco Nasdaq 100 Equal Weight Indx ETF
QQJE.TO	Invesco ESG Nas Next Gen 100 Idx ETF
QQJR.TO	Invesco Nasdaq Next Gen 100 Index ETF
QQQL.TO	Global X Enhanced Nasdaq-100 Index ETF
QQQT.TO	Evolve Nasdaq Tech Index Fnd Hedgd ETF
QQQX.TO	Global X Nasdaq 100 Index ETF
QQQY.TO	Evolve Nasdaq Tech Enh Yld Indx Fund ETF
QRC.TO	Queens Road Capital Investment Ltd
QRET.TO	Mackenzie Dev Mkts Real Estate Index ETF
QSB.TO	Mackenzie CDN Short Term Bond Index ETF
QSR.TO	Restaurant Brands International Inc
QTLT.TO	Mackenzie US Govt Long Bond Index ETF
QTRH.TO	Quarterhill Inc
QUB.TO	Mackenzie US Aggregate Bond Indx Hgd ETF
QUIG.TO	Mackenzie US Inv Grd Corp Bd Idx CAD Hgd
QUS.TO	Quantshrs Enh Core US Equity ETF
QUU.TO	Mackenzie US Large Cap Equity Index ETF
QXM.TO	CI Morningstar Nb Quebec ETF
RAAA.TO	Corton Enhanced Income Fund ETF
RATE.TO	Arrow Ec Income Advantage Alt Fund ETF
RBA.TO	Rb Global Inc
RBNK.TO	RBC CDN Bank Yield Index ETF
RBO.TO	RBC 1 To 5 Yr Laddered Corp Bond ETF
RBOT.TO	GX Robotics & Ai Index ETF
RBY.TO	Rubellite Energy Inc
RCD.TO	RBC Quant CDN Dividend Leaders ETF
RCDC.TO	RBC Canadian Dividend Covered Call ETF
RCG.TO	RF Capital Group Inc
RCH.TO	Richelieu Hardware Ltd
RDBH.TO	RBC US Discount Bond CAD Hedged ETF
REAL.TO	Real Matters Inc
RGQN.TO	RBC Target 2025 Government Bond ETF
RGQO.TO	RBC Target 2026 Government Bond ETF
RGQP.TO	RBC Target 2027 Government Bond ETF
RGQQ.TO	RBC Target 2028 Government Bond ETF
RGQR.TO	RBC Target 2029 Government Bond ETF
RGQS.TO	RBC Target 2030 CDN Government Bond ETF
RID.TO	RBC Quant EAFE Div Leaders ETF
RIDH.TO	RBC Quant EAFE Div Leaders ETF
RIFI.TO	Russell Invt Fixed Income Pool ETF
RIGE.TO	Russell Investments Glb Equity Pool ETF
RIIN.TO	Russell Invt Global Infr Pool ETF
RIRA.TO	Russell Invt Real Assets ETF
RIT.TO	CI Canadian REIT ETF
RLB.TO	RBC 1 To 5 Year Laddered Can Bond ETF
RMAX.TO	Hamilton Reits Yield Maximizer ETF Class
ROOT.TO	Roots Corp
RPD.TO	RBC Quant European Div Leaders ETF
RPDH.TO	RBC Quant European Div Leaders ETF
RPF.TO	RBC Canadian Pref Share ETF
RPSB.TO	RBC Phn Short Term CDN Bond ETF
RQN.TO	RBC Target 2025 Corp Bond Index ETF
RQO.TO	RBC Target 2026 Corporate Bond Index ETF
RQP.TO	RBC Target 2027 Corporate Bond Index ETF
RQQ.TO	RBC Target 2028 Corporate Bond Index ETF
RQR.TO	RBC Target 2029 Corporate Bond Index ETF
RQS.TO	RBC Target 2030 CDN Corp Bond Index ETF
RS.TO	Real Estate Split Corp
RSI.TO	Rogers Sugar Inc
RTG.TO	Rtg Mining Inc
RUBH.TO	RBC US Banks Yield CAD Hgd Index ETF
RUBY.TO	RBC US Banks Yield Index ETF CAD
RUD.TO	RBC Quant US Div Leaders ETF
RUDB.TO	RBC US Discount Bond ETF
RUDC.TO	RBC U.S. Dividend Covered Call ETF
RUDH.TO	RBC Quant US Div Leaders ETF
RUP.TO	Rupert Resources Ltd
RUQN.TO	RBC Target 2025 US Corp Bond ETF
RUQO.TO	RBC Target 2026 US Corp Bond ETF
RUQP.TO	RBC Target 2027 U.S. Corporate Bond ETF
RUQQ.TO	RBC Target 2028 U.S. Corporate Bond ETF
RUQR.TO	RBC Target 2029 US Corp Bond ETF
RUQS.TO	RBC Target 2030 US Corp Bond ETF
RUS.TO	Russel Metals
RUSB.TO	RBC Short Term US Corp Bond ETF
RVX.TO	Resverlogix Corp
RXD.TO	RBC Quant Emrg Mkts Div Leaders ETF
RY.TO	Royal Bank of Canada
S.TO	Sherritt Intl Rv
SAM.TO	Starcore International Mines Ltd
SAP.TO	Saputo Inc
SAU.TO	ST Augustine Gold and Copper Ltd
SBC.TO	Brompton Split Banc Corp Cl A
SBI.TO	Serabi Gold Plc
SBT.TO	Purpose Silver Bullion ETF
SCR.TO	Strathcona Resources Ltd.
SCY.TO	Scandium International Mining Corp
SDE.TO	Spartan Delta Corp
SEA.TO	Seabridge Gold Inc
SEC.TO	Senvest Capital
SES.TO	Secure Energy Services Inc
SFC.TO	Sagicor Financial Company Ltd
SFD.TO	Nxt Energy Solutions Inc
SFI.TO	Solution Financial Inc
SFTC.TO	Softchoice Corp
SGLD.TO	Sabre Gold Mines Corp
SGNL.TO	Signal Gold Inc
SGY.TO	Surge Energy Inc
SHLE.TO	Source Energy Services Ltd
SHOP.TO	Shopify Inc
SIA.TO	Sienna Senior Living Inc
SII.TO	Sprott Inc
SIL.TO	Silvercrest Metals Inc
SIS.TO	Savaria Corp
SJ.TO	Stella Jones Inc
SKE.TO	Skeena Resources Ltd
SKYY.TO	First Trust Cloud Computing ETF
SLF.TO	Sun Life Financial Inc
SLR.TO	Solitario Zinc Corp
SLS.TO	Solaris Resources Inc
SMAX.TO	Hamilton U.S. Equity Yield Maximizer ETF
SMC.TO	Sulliden Mining Capital Inc
SMT.TO	Sierra Metals Inc
SOBO.TO	South Bow Corporation WI
SOIL.TO	Saturn Oil and Gas Inc
SOLG.TO	Solgold Plc
SOY.TO	Sunopta Inc
SPAY.TO	GX Short-Term U.S. Treas Prem Yld ETF
SPB.TO	Superior Plus Corp
SPLT.TO	Brompton Split Corp Preferred Share ETF
SPPP.TO	Sprott Physical Platinum Palladium CAD
SSL.TO	Sandstorm Gold Ltd
SSRM.TO	Ssr Mining Inc
STC.TO	Sangoma Technologies Corp
STCK.TO	Stack Capital Group Inc
STEP.TO	Step Energy Services Ltd
STGO.TO	Steppe Gold Ltd
STLC.TO	Stelco Holdings Inc
STLR.TO	Stllr Gold Inc
STN.TO	Stantec Inc
STPL.TO	BMO Glb Consumer Staples Hgd To CAD ETF
SU.TO	Suncor Energy Inc
SVA.TO	Sernova Corp
SVB.TO	Silver Bull Resources Inc
SVI.TO	Storagevault Canada Inc
SVM.TO	Silvercorp Metals Inc
SVR.TO	Ishares Silver Bullion ETF Hdg
SWP.TO	Swiss Water Decaffeinated Coffee Inc
SXI.TO	Synex Intl J
SXP.TO	Supremex Inc
SYLD.TO	Purpose Strategic Yield Fund
SYZ.TO	Sylogist Ltd
T.TO	Telus Corp
TA.TO	Transalta Corp
TAL.TO	Petrotal Corp
TBAL.TO	TD Balanced Portfolio ETF
TBCE.TO	TD Target 2025 Investment Grade Bond ETF
TBCF.TO	TD Target 2026 Investment Grade Bond ETF
TBCG.TO	TD Target 2027 Investment Grade Bond ETF
TBIL.TO	Harvest Canadian T Bill ETF
TBL.TO	Taiga Building Products Ltd
TBNK.TO	TD Canadian Bank Dividend Index ETF
TC.TO	Tucows Inc
TCBN.TO	TD Global Carbon Credit Index ETF
TCLB.TO	TD Canadian Long Term Fed Bond ETF
TCLV.TO	TD Q Canadian Low Volatility ETF
TCON.TO	TD Conservative Portfolio ETF
TCS.TO	Tecsys Inc J
TCSB.TO	TD Select Short Term Corporate Bond Ladd
TCSH.TO	TD Cash Management ETF
TCW.TO	Trican Well
TD.TO	Toronto-Dominion Bank
TDB.TO	TD CDN Aggregate Bond Index ETF
TDOC.TO	TD Global Healthcare Leaders Index ETF
TEC.TO	TD Global Technology Leaders Index ETF
TECH.TO	Evolve Fangma Index ETF [Cad Hedged Unit
TECI.TO	TD Global Technology Innovators Indx ETF
TECX.TO	TD Global Tech Leaders CAD Hdg Idx ETF
TERM.TO	Manulife Smart Short-Term Bond ETF
TF.TO	Timbercreek Financial Corp
TFII.TO	Tfi International Inc
TFPM.TO	Triple Flag Precious Metals Corp
TGAF.TO	Tralucent Global Alt [Long/Short] Equity Fund
TGED.TO	TD Active Global Enhanced Dividend ETF
TGFI.TO	TD Active Global Income ETF
TGGR.TO	TD Active Global Equity Growth ETF
TGO.TO	Terago Inc
TGRE.TO	TD Active Global Real Estate Equity ETF
TGRO.TO	TD Growth Portfolio ETF
TH.TO	Theratechnologies
The.TO	TD Intl Equity CAD Hedge Index ETF
THNC.TO	Thinkific Labs Inc
THU.TO	TD S&P 500 CAD Hedge Index ETF
TI.TO	Titan Mining Corp
TIH.TO	Toromont Ind
TILV.TO	TD Systematic Intl Equity Low Vol ETF
TINF.TO	TD Active Global Infrastructure Eqty ETF
TIPS.TO	BMO US TIPS Index ETF
TIXT.TO	Telus International [Cda] Inc
TKN.TO	Ninepoint Web3 Innovators Fund
TKO.TO	Taseko Mines Ltd
TLF.TO	Brompton Tech Leaders Income ETF
TLG.TO	Troilus Gold Corp
TLO.TO	Talon Metals Corp
TLRY.TO	Tilray Inc
TLV.TO	Invesco SP TSX Low Vol Idx ETF
TMD.TO	Titan Medical Inc
TMQ.TO	Trilogy Metals Inc
TNZ.TO	Tenaz Energy Corp
TOT.TO	Total Energy Services Inc
TOU.TO	Tourmaline Oil Corp
TOWR.TO	BMO Brookfield Gbl Real Est Tech Fnd ETF
TOY.TO	Spin Master Corp
TPE.TO	TD International Equity Index ETF
TPRF.TO	TD Active Preferred Share ETF
TPU.TO	TD S&P 500 Index ETF
TPZ.TO	Topaz Energy Corp
TQCD.TO	TD Q Canadian Dividend ETF
TQGD.TO	TD Q Global Dividend ETF
TQGM.TO	TD Q Global Multifactor ETF
TQSM.TO	TD Q US Small Mid Cap Eqty ETF
TRI.TO	Thomson Reuters Corp
TRP.TO	TC Energy Corp
TRVI.TO	Harvest Travel and Leisure Income ETF
TRVL.TO	Harvest Travel and Leisure Index ETF
TRX.TO	Trx Gold Corporation
TRZ.TO	Transat At Inc
TSAT.TO	Telesat Corp
TSK.TO	Talisker Resources Ltd
TSL.TO	Tree Island Steel Ltd
TSND.TO	Terrascend Corp
TSU.TO	Trisura Group Ltd
TTNM.TO	Titanium Transportation Group Inc
TTP.TO	TD S&P TSX Capped Comp Index ETF
TTTX.TO	Global X Innov Bluechip Top 10 Ind ETF
TUED.TO	TD Active US Enhanced Dividend ETF
TUEX.TO	TD Active US Enhanced Div CAD Hdg ETF
TUHY.TO	TD Active US High Yield Bond ETF
TULB.TO	TD US Long Term Treasury Bond ETF
TULV.TO	TD Q US Low Volatility ETF
TUSB.TO	TD Select U.S. Short Term Corporate Bond
TVE.TO	Tamarack Valley Energy Ltd
TVK.TO	Terravest Capital Inc
TWC.TO	Twc Enterprises Ltd
TWM.TO	Tidewater Midstream and Infras Ltd
TXF.TO	CI Tech Giants Covered Call ETF
TXG.TO	Torex Gold Resources Inc
TXP.TO	Touchstone Exploration Inc
UDA.TO	Caldwell US Dividend Advantage Fund ETF
UDEF.TO	Manulife Smart U.S. Defensive Equity ETF
UDIV.TO	Manulife Smart U.S. Dividend ETF [Hedged
UMAX.TO	Hamilton Utilities Yield Maximizer ETF
UMI.TO	CI Wisdomtree US Midcap Div Idx Hgd ETF
UNC.TO	United Corp Ltd
UNI.TO	Unisync Corp Class B
URB.TO	Urbana Corp
URC.TO	Uranium Royalty Corp
URE.TO	Ur-Energy Inc
USA.TO	Americas Silver Corp
USCC.TO	GX S&P 500 Covered Call ETF
USCL.TO	GX Enhanced S&P 500 Covered Call ETF
USSL.TO	Global X Enhanced S&P 500 Index ETF
USSX.TO	Global X S&P 500 Index ETF Class A Units
UTES.TO	Evolve CAD Util Enh Yield Idx Fnd ETF
UTIL.TO	GX Canadian Utility Srvs High Divd Idx ETF
VA.TO	Vanguard FTSE Dev Asia Pac All Cap ETF
VAB.TO	Vanguard CDN Aggregate Bond Index ETF
VALT.TO	CI Gold Bullion Fund ETF Hg CAD
VBAL.TO	Vanguard Balanced ETF Portfolio
VBNK.TO	Versabank
VCB.TO	Vanguard CDN Corporate Bond Index ETF
VCE.TO	Vanguard FTSE Canada Index ETF
VCIP.TO	Vanguard Conservative Income ETF
VCM.TO	Vecima Networks Inc
VCN.TO	Vanguard FTSE Canada All Cap ETF
VCNS.TO	Vanguard Conservative ETF Portfolio
VDU.TO	Vanguard FTSE Developed AC Ex US ETF
VDY.TO	Vanguard FTSE CDN High Div Yld Index ETF
VE.TO	Vanguard FTSE Dev Europe All Cap ETF
VEE.TO	Vanguard FTSE Emerging Mkts All Cap ETF
VEF.TO	Vanguard FTSE Dev AC Ex US ETF CAD Hdg
VEQT.TO	Vanguard All Equity ETF Portfolio
VET.TO	Vermilion Energy Inc
VFV.TO	Vanguard S&P 500 Index ETF
VGG.TO	Vanguard US Div Appr ETF
VGH.TO	Vanguard US Div Appr ETF CAD Hdg
VGRO.TO	Vanguard Growth ETF Portfolio
VGV.TO	Vanguard CDN Government Bond Index ETF
VGZ.TO	Vista Gold Corp
VHI.TO	Vitalhub Corp
VI.TO	Vanguard FTSE Dev All Cap Na ETF
VIDY.TO	Vanguard FTSE Dev Ex Na High Div Yld ETF
VIU.TO	Vanguard FTSE Dev All Cap Na ETF
VLB.TO	Vanguard CDN Long Term Bond Index ETF
VLE.TO	Valeura Energy Inc
VLN.TO	Velan Inc Sv
VMO.TO	Vanguard Glob Momentum Factor ETF
VNP.TO	5N Plus Inc
VOXR.TO	Vox Royalty Corp
VPH.TO	Valeo Pharmainc
VQS.TO	Viq Solutions Inc
VRE.TO	Vanguard FTSE CDN Capped REIT Index ETF
VRIF.TO	Vanguard Retirement Income ETF
VRN.TO	Veren Inc
VRTS.TO	Virtus Investment Partners Inc.
VSB.TO	Vanguard CDN Short-Term Bond Index ETF
VSC.TO	Vanguard CDN Short Term Corp Bd ETF
VSP.TO	Vanguard S&P 500 Index ETF CAD Hdg
VUN.TO	Vanguard US Total Market ETF
VUS.TO	Vanguard US Total Mkt ETF CAD Hdg
VVL.TO	Vanguard Glob Val Factor ETF
VVO.TO	Vanguard Global Min Vol ETF
VVSG.TO	Vanguard CDN Ultra Sh Govt Bond Indx ETF
VXC.TO	Vanguard FTSE Global All Cap Ex Can ETF
VXM.TO	CI Morningstar Intl Value Idx ETF
WCN.TO	Waste Connections Inc
WCP.TO	Whitecap Resources Inc
WDO.TO	Wesdome Gold Mines Ltd
WEED.TO	Canopy Growth Corp
WEF.TO	Western Forest Products Inc
WELL.TO	Well Health Technologies Corp
WFC.TO	Wall Financial
WFG.TO	West Fraser Timber CO Ltd
WGX.TO	Westgold Resources Limited
WILD.TO	Wildbrain Ltd
WJX.TO	Wajax Corp
WLLW.TO	Willow Biosciencesinc
WM.TO	Wallbridge Mining Company Ltd
WN.TO	George Weston Limited
WNDR.TO	Wonderfi Technologies Inc.
WOMN.TO	BMO Women IN Leadership Fund
WPK.TO	Winpak Ltd
WPM.TO	Wheaton Precious Metals Corp
WPRT.TO	Westport Fuel Systems Inc
WRG.TO	Western Energy Services Corp
WRN.TO	Western Copper and Gold Corp
WRX.TO	Western Resources Corp
WSP.TO	WSP Global Inc
WSRD.TO	Wealthsimple Dev Mkt Ex Na Soc Resp ETF
WSRI.TO	Wealthsimple Na Socially Resp Index ETF
WTE.TO	Westshore Terminals Investment Corp
WXM.TO	CI Morningstar Cda Momentum Idx ETF
X.TO	TMX Group Ltd
XAD.TO	Ishares U.S. Aerospace & Defense Index ETF
XAGG.TO	Ishares US Aggregate Bond Index ETF
XAGH.TO	Ishares US Aggregate Bond Idx ETF CAD HD
XAM.TO	Xanadu Mines Ltd
XAU.TO	Goldmoney Inc
XAW.TO	Ishares Core MSCI All Cntry Ex Can ETF
XBAL.TO	Ishares Core Balanced ETF Portfolio
XBB.TO	Ishares Core CDN Universe Bond ETF
XBM.TO	Ishares S&P TSX Global Base Mtls ETF
XCB.TO	Ishares Canadian Corporate Bond ETF
XCBG.TO	Ishares ESG Adv CAD Corp Bond Index ETF
XCBU.TO	Ishares US IG Corporate Bond Index ETF
XCD.TO	Ishares S&P Global Cons Disc ETF
XCG.TO	Ishares Canadian Growth Index ETF
XCH.TO	Ishares China Index ETF
XCHP.TO	Ishares Semiconductor Index ETF
XCLN.TO	Ishares Global Clean Energy Index ETF
XCNS.TO	Ishares Core Conservative Balanced ETF
XCS.TO	Ishares S&P TSX Smallcap Index ETF
XCSR.TO	Ishares ESG Advanced MSCI Canada Idx ETF
XCV.TO	Ishares Canadian Value Index ETF
XDG.TO	Ishares Core MSCI Glo Qlty Div ETF
XDGH.TO	Ishares Core MSCI Glo Qlty Div ETF
XDIV.TO	Ishares Core MSCI CAD Qlty Div ETF
XDNA.TO	Ishares Genomics Immunology and Healthcare Index
XDRV.TO	Ishares Glbl Electric Autonomous Veh ETF
XDSR.TO	Ishares ESG Advanced MSCI EAFE Index ETF
XDU.TO	Ishares Core MSCI US Qlty Div ETF
XDUH.TO	Ishares Core MSCI US Qlty Div ETF
XDV.TO	Ishares Canadian Select Div Index ETF
XEB.TO	Ishares JP Morgan USD Emerg Mkts Bd ETF
XEC.TO	Ishares Core MSCI Emerging Mkts IMI ETF
XEF.TO	Ishares Core MSCI EAFE IMI Index ETF
XEG.TO	Ishares S&P TSX Capped Energy Index ETF
XEH.TO	Ishares MSCI Europe IMI Index ETF
XEI.TO	Ishares S&P TSX Comp High Div Index ETF
XEM.TO	Ishares MSCI Emerging Markets ETF
XEMC.TO	Ishares MSCI Emerg Mkts Ex China Idx ETF
XEN.TO	Ishares Jantzi Social Index ETF
XEQT.TO	Ishares Core Equity ETF
XESG.TO	Ishares ESG MSCI Cda Index ETF
XETM.TO	Ishares TSX Energy Transition Materials Index Et
XEU.TO	Ishares MSCI Europe IMI Index ETF
XEXP.TO	Ishares Exponential Tech Index ETF
XFH.TO	Ishares Core MSCI EAFE IMI Index ETF
XFLB.TO	Ishares Core CDN 15 Year Fed Bnd Idx ETF
XFLI.TO	Ishares Flexible Monthly Income ETF
XFLX.TO	Ishares Flexible Monthly Income ETF
XFN.TO	Ishares S&P TSX Capped Financials ETF
XFR.TO	Ishares Floating Rate Index ETF
XGB.TO	Ishares Canadian Govt Bond Index ETF
XGD.TO	Ishares S&P TSX Global Gold Index ETF
XGI.TO	Ishares S&P Global Industrials ETF
XGRO.TO	Ishares Core Growth ETF Portfolio
XHAK.TO	Ishares Cybersecurity and Tech Index ETF
XHB.TO	Ishares CDN Hybrid Corp Bond ETF
XHC.TO	Ishares Global Healthcare Index ETF
XHD.TO	Ishares US High Div Equity Index ETF
XHU.TO	Ishares US High Div Equity Index ETF
XHY.TO	Ishares US High Yield Bond Index ETF
XIC.TO	Ishares Core S&P TSX Capped Comp ETF
XID.TO	Ishares India Index ETF
XIG.TO	Ishares US IG Corporate Bond Index ETF
XIGS.TO	Ishares 1 To 5 Year US IG Corp Bond ETF
XIN.TO	Ishares MSCI EAFE Index ETF
XINC.TO	Ishares Core Income Balanced ETF
XIT.TO	Ishares S&P TSX Capped Info Tech ETF
XIU.TO	Ishares S&P TSX 60 Index ETF
XLB.TO	Ishares Core CDN Long Term Bond ETF
XLVE.TO	Mulvihill US Hlth Care Enhanc Yld ETF
XLY.TO	Auxly Cannabis Group Inc
XMA.TO	Ishares S&P TSX Capped Materials ETF
XMC.TO	Ishares S&P US Midcap Index ETF
XMD.TO	Ishares S&P TSX Completion Index ETF
XMH.TO	Ishares S&P US Midcap Index ETF CAD Hgd
XMI.TO	Ishares Edge MSCI Min Vol EAFE ETF
XML.TO	Ishares Edge MSCI Mv EAFE ETF CAD Hgd
XMM.TO	Ishares Edge MSCI Min Vol Emerg ETF
XMS.TO	Ishares Edge MSCI Mv USA ETF CAD Hgd
XMTM.TO	Ishares Edge MSCI USA Momnt Fctr ETF
XMU.TO	Ishares Edge MSCI Min Vol USA ETF
XMV.TO	Ishares Edge MSCI Min Vol Can ETF
XMW.TO	Ishares Edge MSCI Min Vol Gbl ETF
XMY.TO	Ishares Edge MSCI Mv Global ETF CAD Hgd
XPF.TO	Ishares S&P TSX Na Pref Stock ETF
XQB.TO	Ishares High Qlty Canadian Bond ETF
XQLT.TO	Ishares Edge MSCI USA Qlty Fctr Indx ETF
XQQ.TO	Ishares Nasdaq 100 Index ETF
XQQU.TO	Ishares Nasdaq 100 Index ETF
XRB.TO	Ishares CDN Real Return Bond Index ETF
XRE.TO	Ishares S&P TSX Capped REIT Index ETF
XSAB.TO	Ishares ESG CDN Agg Bond Index ETF
XSB.TO	Ishares Core CDN Short Trm Bond ETF
XSC.TO	Ishares Cons ST Strat Fix Inc ETF
XSE.TO	Ishares Cons Strat Fix Inc ETF
XSEA.TO	Ishares ESG MSCI EAFE Index ETF
XSEM.TO	Ishares ESG MSCI Emerg Mkts Index ETF
XSH.TO	Ishares Core CDN ST Corp Maple Bnd ETF
XSHG.TO	Ishares ESG Adv 1 To 5 Yr CAD Bd Idx ETF
XSHU.TO	Ishares 1 To 5 Year US IG Corp Bond ETF
XSI.TO	Ishares Short Term Strategic FI ETF
XSMC.TO	Ishares SP US Small Cap Index ETF
XSMH.TO	Ishares SP US Small Cap ETF CAD Hdg
XSP.TO	Ishares Core S&P 500 ETF CAD Hdg ETF
XSPC.TO	Ishares S&P 500 3% Capped Index ETF [Cad-Hedged]
XST.TO	Ishares S&P TSX Capped Cons Stpl ETF
XSTB.TO	Ishares ESG CDN ST Bond Index ETF
XSTH.TO	Ishares 0 To 5 Year TIPS Bond Idx HD ETF
XSTP.TO	Ishares 0 To 5 Year TIPS Bond Index ETF
XSU.TO	Ishares US Small Cap Index ETF
XSUS.TO	Ishares ESG MSCI USA Index ETF
XTC.TO	Exco Tech
XTD.TO	Tdb Split Corp Class A Shares
XTG.TO	Xtra Gold Resources Corp
XTLH.TO	Ishares 20 Year US Treasury Bond Hdg ETF
XTLT.TO	Ishares 20 Year US Treasury Bond ETF
XTR.TO	Ishares Diversified Monthly Income ETF
XTRA.TO	Patriot One Technologies Inc
XUH.TO	Ishares Core S&P US Total Mkt ETF CAD Heg
XUS.TO	Ishares Core S&P 500 Index ETF
XUSC.TO	Ishares S&P 500 3% Capped Index ETF
XUSF.TO	Ishares SP US Financials Index ETF
XUSR.TO	Ishares ESG Advanced MSCI USA Index ETF
XUT.TO	Ishares S&P TSX Capped Utilities ETF
XUU.TO	Ishares Core S&P US Total Market ETF
XVLU.TO	Ishares Edge MSCI USA Value Fctr ETF
XWD.TO	Ishares MSCI World Index ETF
Y.TO	Yellow Pages Ltd
YCM.TO	Commerce Split Corp Capital Shares
YGR.TO	Yangarra Resources Ltd
YRB.TO	Yorbeau Resources Inc
ZACE.TO	BMO US All Cap Equity Fund ETF
ZAG.TO	BMO Aggregate Bond Index ETF
ZBAL.TO	BMO Balanced ETF
ZBBB.TO	BMO BBB Corporate Bond Index ETF
ZBI.TO	BMO Canadian Bank Income Index ETF
ZBK.TO	BMO Equal Weight US Bank ETF
ZCB.TO	BMO Corporate Bond Index ETF
ZCDB.TO	BMO Corporate Discount Bond ETF
ZCH.TO	BMO China Equity Index ETF
ZCLN.TO	BMO Clean Energy Index ETF
ZCM.TO	BMO Mid Corporate Bond ETF
ZCN.TO	BMO S&P TSX Capped Comp ETF
ZCON.TO	BMO Conservative ETF
ZCPB.TO	BMO Core Plus Bond Fund
ZCS.TO	BMO Short Corp Bond ETF
ZDB.TO	BMO Discount Bond ETF
ZDH.TO	BMO Intl Div CAD Hedge ETF
ZDI.TO	BMO International Dividend ETF
ZDJ.TO	BMO DJIA Hedged To CAD Index ETF
ZDM.TO	BMO MSCI EAFE Hedged To CAD Index ETF
ZDV.TO	BMO Canadian Dividend ETF
ZDY.TO	BMO US Dividend ETF CAD
ZEA.TO	BMO MSCI EAFE ETF
ZEAT.TO	BMO Global Agriculture ETF
ZEB.TO	BMO S&P TSX Equal Weight Banks Index ETF
ZEF.TO	BMO Emg Mkt Bond Hdgd To CAD ETF
ZEM.TO	BMO MSCI Emerging Markets Index ETF
ZEO.TO	BMO S&P TSX Eql Weight Oil Gas Index ETF
ZEQ.TO	BMO MSCI EU Hq Hcad ETF
ZEQT.TO	BMO All-Equity ETF
ZESG.TO	BMO Balanced ESG ETF
ZFC.TO	BMO Sia Focused Canadian Equity Fund
ZFH.TO	BMO Floating Rate High Yield ETF
ZFL.TO	BMO Long Fed Bond Index ETF
ZFM.TO	BMO Mid Federal Bond Index ETF
ZFN.TO	BMO Sia Focused North American Equity Fu
ZFS.TO	BMO Short Federal Bond Index ETF
ZGB.TO	BMO Government Bond Index ETF
ZGD.TO	BMO S&P TSX Eql Weight Global Gold ETF
ZGI.TO	BMO Global Infrastructure Index ETF
ZGLD.TO	BMO Gold Bullion ETF
ZGLH.TO	BMO Gold Bullion Hedged To CAD ETF
ZGQ.TO	BMO MSCI All Cntry Wrld High Qlty ETF
ZGRN.TO	BMO MSCI ACWI Paris Aligned Climate Equi
ZGRO.TO	BMO Growth ETF
ZGSB.TO	BMO Global Strategic Bond Fund
ZHP.TO	BMO US Pref Share Hgd To CAD ETF
ZHU.TO	BMO Equal Weight US Health Care Idx ETF
ZHY.TO	BMO High Yld US Corp Bnd Hdg CAD ETF
ZIC.TO	BMO Mid Term US IG Corp Bond ETF
ZID.TO	BMO India Equity Index ETF
ZIN.TO	BMO S&P TSX Equal Weight Indstrl ETF
ZIU.TO	BMO S&P/Tsx 60 Index ETF
ZJG.TO	BMO Junior Gold Index ETF
ZJK.TO	BMO High Yield US Corp Bond ETF
ZJPN.TO	BMO Japan Index ETF
ZLB.TO	BMO Low Volatility CAD Equity ETF
ZLC.TO	BMO Long Corporate Bond Index ETF
ZLD.TO	BMO Low Vol Intl Eqty Hed To CAD ETF
ZLE.TO	BMO Low Vol Emerg Mkt Equity ETF
ZLH.TO	BMO Low Vol US Eqty Hed To CAD ETF
ZLI.TO	BMO Low Vol Intl Equity ETF
ZLSC.TO	BMO Long Short Canadian Equity ETF
ZLSU.TO	BMO Long Short US Equity ETF
ZLU.TO	BMO Low Volatility US Equity ETF CAD
ZMBS.TO	BMO Canadian MBS Index ETF
ZMI.TO	BMO Monthly Income ETF
ZMID.TO	BMO SP US Mid Cap Index ETF
ZMMK.TO	BMO Money Market Fund ETF
ZMP.TO	BMO Mid Provincial Bond Index ETF
ZMSB.TO	BMO Global Multi Sector Bond Fund
ZMT.TO	BMO Sptsx Eql Wgt Glb Metal Hed CAD ETF
ZMU.TO	BMO Mid Term US IG Corp Bd Hgd CAD Idx
ZNQ.TO	BMO Nasdaq 100 Equity Index ETF
ZPAY.TO	BMO Premium Yield ETF
ZPH.TO	BMO US Put Write Hedged To CAD ETF
ZPL.TO	BMO Long Provincial Bond Index ETF
ZPR.TO	BMO Laddered Pref Share ETF
ZPS.TO	BMO Short Provincial Bond Index ETF
ZPW.TO	BMO US Put Write ETF
ZQB.TO	BMO High Quality Corporate Bond Idx ETF
ZQQ.TO	BMO Nasdaq 100 Hedged To CAD Index ETF
ZRE.TO	BMO Equal Weight Reits Index ETF
ZRR.TO	BMO Real Return Bond Index ETF
ZSB.TO	BMO Short Term Bond Idx ETF
ZSDB.TO	BMO Short Term Discount Bond ETF
ZSML.TO	BMO SP US Small Cap Index ETF
ZSP.TO	BMO S&P 500 Index ETF
ZST.TO	BMO Ultra Short Term Bond ETF
ZSU.TO	BMO ST US IG Corp Bond Hcad ETF
ZTIP.TO	BMO Short Term US TIPS Index ETF
ZUAG.TO	BMO US Aggregate Bond Index ETF
ZUB.TO	BMO Eql Wgt US Bank Hdgd To CAD ETF
ZUCM.TO	BMO USD Cash Management ETF
ZUD.TO	BMO US Dividend Hedged To CAD ETF
ZUE.TO	BMO S&P 500 Hedged CAD ETF
ZUGE.TO	BMO US Equity Growth Mfr Fund ETF
ZUH.TO	BMO Eql Wgt US Hcare Hdgd To CAD ETF
ZUP.TO	BMO US Pref Share Index ETF
ZUQ.TO	BMO MSCI USA High Quality Index ETF
ZUT.TO	BMO Equal Weight Utilities Index ETF
ZUVE.TO	BMO US Equity Value Mfr Fund ETF
ZVC.TO	BMO MSCI Cda Value Index ETF
ZVU.TO	BMO MSCI USA Value Index ETF
ZWA.TO	BMO Covered Call DJIA CAD ETF
ZWB.TO	BMO Covered Call Canadian Banks ETF
ZWC.TO	BMO CDN High Div Covered Call ETF
ZWE.TO	BMO Europe High Div CC CAD Hedge ETF
ZWEN.TO	BMO Covered Call Energy ETF
ZWG.TO	BMO Gbl High Dividend Covered Call ETF
ZWH.TO	BMO US High Dividend Covered Call ETF
ZWHC.TO	BMO Covered Call Health Care ETF
ZWK.TO	BMO Covered Call US Banks ETF
ZWP.TO	BMO Europe High Div Cov Call ETF
ZWQT.TO	BMO Global Enhanced Income Fund ETF
ZWS.TO	BMO US High Div Cov Call Hgd ETF
ZWT.TO	BMO Covered Call Technology ETF
ZWU.TO	BMO Covered Call Utilities ETF
ZXM.TO	CI Morningstar Intl Momentum Idx ETF
ZZZ.TO	Sleep Country Canada Holdings Inc
ZZZD.TO	BMO Tactical Dividend ETF Fund
