A.H.V	Armor Minerals Inc
AAA.P.V	First Tidal Acquisition Corp
AAAJ.P.V	Aaj Capital 3 Corp.
AAG.V	Aftermath Silver Ltd
AAN.V	Aton Resources Inc
AAZ.V	Azincourt Energy Corp
AB.H.V	Asbestos Corp Ltd
ABA.V	Abasca Resources Inc
ABI.V	Abcourt Mines Inc
ABM.V	Aben Minerals Ltd
ABR.V	Arbor Metals Corp
ABRA.V	Abrasilver Resource Corp
ABZ.V	Asiabasemetals Inc
ACAP.P.V	Atlas One Capital Corporation
ACDC.V	Ac/Dc Battery Metals Inc.
ACR.H.V	Auscan Resources Inc
ACU.V	Aurora Solar Technologies Inc
ADD.V	Arctic Star Exploration Corp
ADE.V	Adex Mining Inc
ADG.H.V	Arcus Development Group Inc
ADJ.P.V	Ad4 Capital Corp
ADK.V	Diagnos Inc
ADR.H.V	Arcland Resources Inc
ADY.V	Adyton Resources Corp
ADYA.V	Adya Inc
ADZ.V	Adamera Minerals Corp
AE.V	American Eagle Gold Corp
AEC.V	Anfield Energy Inc
AEC.WT.V	Anfield Energy Inc
AEMC.V	Alaska Energy Metals Corp
AEP.V	Atlas Engineered Products Ltd
AERO.V	Aero Energy Ltd
AFCC.H.V	Automotive Finco Corp
AFE.V	Africa Energy Corp
AFM.V	Alphamin Resources Corp
AFR.V	African Metals Corp
AGH.H.V	Canadian Silver Hunter Inc
AGLD.V	Austral Gold Ltd
AGMR.V	Silver Mountain Resources Inc
AGMR.WT.A.V	Silver Mountain Resources Inc.
AGMR.WT.B.V	Silver Mountain Resources Inc.
AGT.V	Applied Graphite Technologies Corp
AGX.V	Silver X Mining Corp
AHR.V	Amarc Resources Ltd
AIP.U.V	Aip Realty Trust USD
AIR.V	Clean Air Metals Inc
AIS.V	Ais Resources Ltd
AISX.V	Aisix Solutions Inc
AIV.P.V	Apolo IV Acquisition Corp
AIVC.V	Ai Artificial Intelligence Ventures Inc
AJA.V	Aja Health and Wellness Inc
AKH.H.V	Alaska Hydro Corp
AKR.V	Ackroo Inc
AL.V	Alx Resources Corp
ALBT.P.V	Albatros Acquisition Corporation Inc
ALDE.V	Aldebaran Resources Inc
ALEX.V	Alpha Exploration Ltd
ALM.V	Alliance Mining Corp
ALT.V	Alturas Minerals Corp.
ALTA.V	Altamira Gold Corp
ALV.V	Alvopetro Energy Ltd
ALY.V	Analytixinsight Inc
AME.V	Abacus Mining and Exploration
AMG.P.V	Amg Acquisition Corp
AMK.V	American Creek Resources Ltd
AML.V	Akwaaba Mining Ltd
AMMO.V	Bullet Exploration Inc
AMRQ.V	Amaroq Minerals Ltd
AMT.V	Ameritrust Financial Technologies Inc
AMX.V	AMEX Exploration Inc
AMY.V	Recylico Battery Materials Inc
AMZ.V	Azucar Minerals Ltd
ANK.V	Angkor Resources Corp
ANOR.V	Anortech Inc
ANTL.V	Antler Gold Inc
APGO.V	Apollo Silver Corp
APL.V	Appulse Corp
APM.V	Andean Precious Metals Corp
APMI.V	Apogee Minerals Ltd
APN.V	Altiplano Minerals Ltd
APX.V	Apex Resources Inc
AQS.V	Aequus Pharmaceuticals Inc
ARC.V	Arcpoint Inc
ARCH.V	Arch Biopartners Inc
ARD.V	Armada Data Corp
ARGH.V	Argo Corporation
ARH.V	Altima Resources Ltd
ARIC.V	Awale Resources Ltd
ARJN.V	Aranjin Resources Ltd
ARK.V	Arras Minerals Corp
ARL.V	Aurum Lake Mining Corporation
AROW.P.V	Four Arrows Capital Corp
ART.V	Arht Media Inc
ARTG.V	Artemis Gold Inc
ARU.V	Aurania Resources Ltd
ARU.WT.B.V	Aurania Resources Ltd
ASG.V	Aurora Spine Corp
ASL.V	Argentum Silver Corp
AST.V	Astron Connect Inc
ASTR.V	Astra Exploration Inc
ATI.V	Altai Resources Inc
ATOM.V	Atomic Minerals Corp
ATX.V	Atex Resources Inc
ATY.V	Atico Mining Corp
AU.V	Aurion Resources Ltd
AUAU.V	Allegiant Gold Ltd
AUEN.V	Golden Sky Minerals Corp
AUGC.V	Au Gold Corp
AUM.V	Aumega Metals Ltd
AUMB.V	1911 Gold Corp
AUQ.V	Auq Gold Mining Inc
AUR.H.V	Aurora Royalties Inc
AUTO.V	Carbeeza Inc
AUU.V	Gold79 Mines Ltd
AUUA.V	Aluula Composites Inc
AVCR.V	Avricore Health Inc
AVG.V	Avidian Gold Corp
AVN.V	Avanti Helium Corp
AVN.WT.A.V	Avanti Helium Corp Wts A
AVR.V	Avaron Mining Corp
AVU.V	Avrupa Minerals Ltd
AWE.V	Thunderstruck Resources Ltd
AWI.V	Advent Awi Holdings Inc
AWM.V	Angel Wing Metals Inc
AWX.V	Arcwest Exploration Inc
AXE.V	Acceleware Ltd
AXL.V	Arrow Exploration Corp
AZC.P.V	A2Zcryptocap Inc
AZM.V	Azimut Exploration Inc
AZR.V	Azarga Metals Corp
AZS.V	Arizona Gold & Silver Inc
AZT.V	Aztec Minerals Corp
B.V	Bcm Resources Corp
BAG.V	Blende Silver Corp
BARU.V	Baru Gold Corp
BAT.V	Batero Gold Corp
BAU.V	Blue Star Gold Corp
BAV.H.V	Bravern Ventures Ltd
BAY.V	Aston Bay Holdings Ltd
BBB.V	Brixton Metals Corp
BCC.H.V	Bantam Capital Corp.
BCF.V	Builders Capital Mortgage Corp
BCHT.V	Birchtech Corp
BCM.V	Bear Creek Mining Corp
BCM.WT.V	Bear Creek Mining Corporation
BCU.V	Bell Copper Corp
BDGC.H.V	Boundary Gold and Copper Mining Ltd
BEA.V	Belmont Resources Inc
BECN.V	Beacn Wizardry and Magic Inc
BES.V	Braille Energy Systems Inc
BET.V	Northstar Gaming Holdings Inc
BEW.V	Bewhere Holdings Inc
BEX.V	Benton Resources Inc
BFM.V	Bedford Metals Corp
BGA.V	Bioneutra Global Corp
BGD.V	Bullion Gold Resources Corp
BGE.V	Blue Sky Global Energy Corp
BGF.V	Beauce Gold Fields Inc
BGS.V	Baroyeca Gold and Silver Inc
BHLI.V	Bradda Head Lithium Limited
BHS.V	Bayhorse Silver Inc
BIG.V	Hercules Metals Corp
BIGG.V	Bigg Digital Assets Inc
BIGT.V	Big Tree Carbon Inc
BILD.V	Builddirect.com Technologies Inc
BIRD.V	Thunderbird Minerals Corp
BITK.V	Blockchaink2 Corp
BKM.V	Pacific Booker Minerals Inc
BKMT.V	Blockmint Technologies Inc
BLDS.V	Badlands Resources Inc
BLM.V	Blumetric Environmental Inc
BLOK.H.V	Globalblock Digital Asset Trading Ltd
BLUE.V	Mines D'Or Orbec Inc
BM.V	Bc Moly Ltd
BMET.V	Bemetals Corp
BMK.V	Macdonald Mines Expl Ltd
BMM.V	Black Mammoth Metals Corp
BMR.V	Battery Mineral Resources Corp
BMV.V	Bathurst Metals Corp
BNKR.V	Bunker Hill Mining Corp
BNXA.V	Banxa Holdings Inc.
BNZ.V	Bonanza Mining Corp
BOCA.V	Bocana Resources Corp
BOGO.V	Borealis Mining Company Limited
BOL.V	Bold Ventures Inc
BONE.V	Boron One Holdings Inc
BP.H.V	Backstageplay Inc.
BQE.V	Bqe Water Inc
BRAU.V	Big Ridge Gold Corp
BRC.V	Blackrock Silver Corp
BRED.V	Purebred Brands Inc
BRL.H.V	Bearclaw Capital Corp
BRM.V	Biorem Inc
BRN.PR.A.V	Brookfield Investments Corp Pref A
BRO.V	Barksdale Resources Corp
BRON.V	Bronco Resources Corp
BRTA.H.V	Beretta Ventures Ltd
BRVO.V	Bravo Mining Corp
BRW.V	Brunswick Exploration Inc
BSK.V	Blue Sky Uranium Corp
BSR.V	Bluestone Resources Inc
BST.V	Bessor Minerals Inc.
BTCW.V	Bitcoin Well Inc
BTR.V	Bonterra Resources Inc
BTT.V	Bitterroot Resources Ltd
BTU.V	Btu Metals Corp
BTV.V	Bluerush Inc
BUZ.P.V	Buzz Capital Inc
BUZH.P.V	Buzz Capital 2 Inc
BVA.V	Bravada Gold Corp
BWLK.V	Boardwalktech Software Corp
BWR.V	Bwr Exploration Inc
BYM.H.V	Baymount Incorporated
BYN.V	Banyan Gold Corp
BZ.V	Benz Mining Corp
CAC.P.V	Cinaport Acquisition Corp III
CAD.V	Colonial Coal International Corp
CAF.V	Canaf Investments Inc
CAG.V	Composite Alliance Group Inc
CAI.V	Capitan Investment Ltd
CAM.V	Cascadia Minerals Ltd
CANB.V	Canadabis Capital Inc
CAND.V	Candelaria Mining Corp
CANS.V	Wildpack Beverage Inc
CANX.V	Canex Metals Inc
CAPT.V	Captain Silver Corp
CART.H.V	Carcetti Capital Corp
CASA.V	Casa Minerals Inc
CAU.H.V	China Goldcorp Ltd
CBA.V	Champion Bear Res Ltd
CBG.V	Chibougamau Independent Mines Inc
CBI.V	Colibri Resource Corp
CBIT.V	Cathedra Bitcoin Inc
CBLT.V	Cblt Inc
CBLU.V	Clear Blue Technologies Intl Inc
CBR.V	Cabral Gold Inc
CBV.V	Cobra Venture Corp
CCB.V	Canada Carbon Inc
CCCM.V	C3 Metals Inc
CCD.V	Cascadero Copper Corp
CCE.V	Commerce Resources Corp
CCIC.P.V	Chicane Capital I Corp
CCMI.V	Canadian Critical Minerals Inc
CD.V	Cantex Mine Development Corp
CDA.V	Canuc Resources Corp
CDB.V	Cordoba Minerals Corp
CEBI.V	Ce Brands Inc
CEC.V	Canasia Energy Corp
CEI.V	Coelacanth Energy Inc.
CELL.V	Grid Battery Metals Inc
CEN.H.V	Claren Energy Corp
CEQ.V	Criterium Energy Ltd
CERT.V	Cerrado Gold Inc
CFA.H.V	Clear Gold Resources Inc
CFY.V	Cf Energy Corp
CGC.V	Canadian Gold Corp
CGD.V	Carlin Gold Corp
CH.V	Charbone Hydrogen Corporation
CHIP.H.V	Health Logic Interactive Inc
CIO.V	Central Iron Ore Ltd
CKG.V	Chesapeake Gold Corp
CLCO.V	Culico Metals Inc
CLIC.V	Comet Lithium Corp.
CLIP.V	Clip Money Inc
CLM.V	Consolidated Lithium Metals Inc
CLUS.V	Colossus Resources Corp
CLV.V	Canoe Mining Ventures Corp
CMB.V	Cmc Metals Ltd
CMC.V	Cielo Waste Solutions Corp
CMD.V	Commander Resources Ltd
CMI.V	C-COM Satellite Systems Inc
CMIL.V	Capella Minerals Ltd
CML.V	Canickel Mining Ltd
CMO.H.V	Cliffmont Resources Ltd.
CMU.V	Comet Industries Ltd
CN.V	Condor Resources Inc
CNC.V	Canada Nickel Company Inc
CNO.V	California Nanotechnologies Corp
CNRI.V	Canadian North Resources Inc
CNST.P.V	Constellation Capital Corp
CNVI.V	Conavi Medical Corp
CNX.V	Callinex Mines Inc
COCO.V	Coast Copper Corp.
COLL.P.V	Collingwood Resources Corp
CONE.V	Canada One Mining Corp
COO.V	Naturebank Asset Management Inc
COR.V	Camino Minerals Corp
COS.V	Coniagas Battery Metals Inc
COSA.V	Cosa Resources Corp.
COV.V	Covalon Technologies Ltd
CPAU.V	Copaur Minerals Inc
CPER.V	Coppercorp Resources Inc
CPL.V	Copper Lake Resources Ltd
CPS.V	Canadian Premium Sand Inc
CQR.V	Conquest Resources Ltd
CRB.V	Cariboo Rose Resources Ltd
CRBK.V	Carebook Technolgies Inc
CRD.V	Copper Road Resources Inc
CRE.V	Critical Elements Lithium Corp
CRI.V	Churchill Resources Inc
CSG.H.V	Cosigo Resources Ltd
CSL.H.V	Comstock Metals Ltd.
CSO.V	Corsa Coal Corp
CSOC.A.V	Canso Select Opportunities Corp Class A
CSOC.B.V	Canso Select Opportunities Corp Class B
CSPN.V	Carespan Health Inc
CSTR.V	Cryptostar Corp
CTEK.V	Cleantek Industries Inc
CTG.V	Centenario Gold Corp
CTH.V	Cotec Holdings Corp
CTM.V	Canterra Minerals Corp
CTN.V	Centurion Minerals Ltd
CTRL.V	Edge Total Intelligence Inc
CTZ.V	Namsys Inc
CUCO.H.V	African Energy Metals Inc
CUCU.V	Global Copper Corp
CUEX.V	Copperex Resources Corporation
CUSN.V	Cornish Metals Inc
CUU.V	Copper Fox Metals Inc
CVB.V	Compass Gold Corp
CVV.V	Canalaska Uranium Ltd
CVW.V	Cvw Cleantech Inc
CWV.V	Crown Point Energy Inc
CYBE.V	Cybercatch Holdings Inc
CYF.V	Canyon Creek Food CO Ltd
CYL.V	Ceylon Graphite Corp
CYM.V	Cymat Technologies Ltd
CYTO.V	Cytophage Technologies Ltd.
CZZ.V	Cleghorn Minerals Ltd
DAN.V	Arianne Phosphate Inc
DAR.V	Darelle Online Solutions Inc
DAT.H.V	Datum Ventures Inc
DAU.V	Desert Gold Ventures Inc
DB.V	Decibel Cannabis Company Inc
DBC.P.V	Departure Bay Capital Corp
DBG.V	Doubleview Gold Corp
DCMC.V	Dore Copper Mining Corp
DCOP.V	District Copper Corp
DE.V	Decisive Dividend Corp
DE.WT.V	Decisive Dividend Corporation Wts
DEAL.V	Playgon Games Inc
DEC.V	Decade Resources Ltd
DEF.V	Defiance Silver Corp
DEFN.V	Defense Metals Corp
DELX.V	Delphx Capital Markets Inc
DEX.V	Almadex Minerals Ltd
DFR.V	Dfr Gold Inc
DG.V	Dixie Gold Inc
DGHI.V	Digihost Technology Inc
DGO.V	Durango Resources Inc
DGTL.V	Dgtl Holdings Inc
DHB.V	Delivra Health Brands Inc
DHR.V	Discovery Harbour Resources Corp
DIG.H.V	District Mines Ltd
DLP.V	Dlp Resources Inc
DLTA.V	Delta Resources Ltd
DM.V	Datametrex Ai Ltd
DME.V	Desert Mountain Energy Corp
DMGI.V	Dmg Blockchain Solutions Inc
DMI.V	Diamcor Mining Inc
DMX.V	District Metals Corp
DNO.V	Dinero Ventures Ltd
DOS.V	Dios Exploration Inc
DRY.V	Dryden Gold Corp
DSY.V	Destiny Media Technologies Inc
DTEA.V	Davidstea Inc
DTWO.V	D2 Lithium Corp
DV.V	Dolly Varden Silver Corp
DWS.V	Diamond Estates Wines and Spirits Inc
DYG.V	Dynasty Gold Corp
EAM.V	East Africa Metals Inc
EAU.V	Engineer Gold Mines Ltd
EBM.V	Eastwood Bio Medical Canada Inc
ECAP.P.V	Endurance Capital Corp
ECM.V	Ecolomondo Corp
ECOM.V	Emerge Commerce Ltd
ECR.V	Cartier Resources Inc
ECU.V	Element 29 Resources Inc
EDDY.V	Edison Battery Metals Corp
EDG.V	Endurance Gold Corp
EDM.V	Edm Resources Inc
EDY.V	Eddy Smart Home Solutions Ltd
EFF.V	1844 Resources Inc
EGM.V	Engold Mines Ltd
EGR.V	Egr Exploration Ltd
EGT.V	Eguana Technologies Inc
EIRE.P.V	Monaghan Capital Fund Ltd
EKG.V	Cardiocomm Solutions Inc.
ELBM.V	Electra Battery Metals Corp
ELC.V	Elysee Development Corp
ELE.V	Elemental Altus Royalties Corp
ELEC.V	Electric Royalties Ltd
ELL.V	Everybody Loves Languages Corp
ELM.V	Element Lifestyle Retirement Inc
ELY.V	Electrum Discovery Corp
EML.V	Electric Metals [Usa] Ltd
EMM.V	Giyani Metals Corp
EMN.V	Euro Manganese Inc
EMNT.V	Eminent Gold Corp
EMO.V	Emerita Resources Corp
EMPR.V	Empress Royalty Corp
EMR.V	Emergent Metals Corp
EMX.V	Emx Royalty Corp
ENA.V	Enablence Technologies Inc
ENDR.V	Enduro Metals Corp
ENEV.V	Enerev5 Metals Inc
ENRG.V	New Energy Metals Corp
ENTG.V	Entourage Health Corp
ENW.V	Enwave Corp
EOG.V	Eco Atlantic Oil and Gas Ltd
EON.V	Eon Lithium Corp
EOX.V	Euromax Resources Ltd
EP.V	Empire Metals Corp
EPF.V	Everyday People Financial Corp
EPL.V	Eagle Plains Resources Ltd
EPO.H.V	Encanto Potash Corp
EQ.V	Eq Inc
EQTY.V	Equity Metals Corp
ERA.V	Elcora Advanced Materials Corp
ERC.V	Eros Resources Corp
ESE.V	Ese Entertainment Inc
ESK.V	Eskay Mining Corp
ESPN.V	Hispania Resoucres Inc
ETF.V	Eastfield Resources Ltd
ETL.V	E3 Lithium Ltd
ETU.V	E2Gold Inc
EU.V	Encore Energy Corp
EVER.V	Evergold Corp
EVGN.V	Evergen Infrastructure Corp
EVMT.V	Evome Medical Technologies Inc
EVNI.V	Ev Nickel Inc
EVOC.P.V	Evocati Capital Resources Inc
EW.V	East West Petroleum Corp
EWK.V	Earthworks Industries Inc
EWS.V	Environmental Waste International Inc
EXG.V	Exgen Resources Inc
FA.V	Fountain Asset Corp
FAIR.V	Fairchild Gold Corp
FAN.V	First Atlantic Nickel Corp
FARM.V	Deveron Corp
FAS.V	First Andes Silver Ltd
FBF.V	Fab-Form Industries Ltd
FBR.H.V	Fibre-Crown Manufacturing Inc.
FCA.U.V	Firm Capital Apartment Real Estate Investment TR
FCA.UN.V	Firm Capital Apartment Real Estate Investment TR
FCGV.V	Florida Canyon Gold Inc
FCLI.V	Full Circle Lithium Corp
FDI.V	Findev Inc
FDR.V	Founders Metals Inc
FEO.V	Oceanic Iron Ore Corp
FEX.V	Fjordland Exploration Inc
FFOX.V	Firefox Gold Corp
FG.V	Falcon Gold Corp
FGCC.P.V	First and Goal Capital Corp
FHR.V	Fiddlehead Resources Corp
FHR.WT.V	Fiddlehead Resources Corp Wts
FHYD.V	First Hydrogen Corp
FIN.V	European Energy Metals Corp
FIND.V	Baselode Energy Corp
FISH.V	Sailfish Royalty Corp
FKM.V	Fokus Mining Corp
FL.V	Frontier Lithium Inc
FLCN.V	Falcon Energy Materials Plc
FLT.V	Volatus Aerospace Inc
FLY.V	Flyht Aerospace Solutions Ltd
FLYN.V	Flying Nickel Mining Corp
FMAN.V	Freeman Gold Corp
FMAN.WT.U.V	Freeman Gold Corp
FMC.V	Forum Energy Metals Corp
FMM.V	Full Metal Minerals Ltd
FMN.V	Fidelity Minerals Corp
FMS.V	Focus Graphite Inc
FMT.V	Fuerte Metals Corporation
FNC.V	Fancamp Exploration Ltd
FNM.V	First Nordic Metals Corp
FNR.V	49 North Resources Inc
FO.V	Falcon Oil & Gas Ltd
FOBI.V	Fobi Ai Inc
FONC.P.V	Florence One Capital Inc
FOR.V	Fortune Bay Corp
FP.V	Fp Newspapers Inc
FPC.V	Falco Resources Ltd
FPX.V	Fpx Nickel Corp
FRDY.H.V	Fridays Dog Holdings Inc.
FRE.V	Fremont Gold Ltd
FRED.V	Fredonia Mining Inc
FREQ.V	Frequency Exchange Corp
FRI.V	Freeport Resources Inc
FRNT.V	Frnt Financial Inc
FRSH.V	The Fresh Factory B.C Ltd.
FTEC.V	Fintech Select Ltd
FTI.V	Fti Foodtech International Inc
FTZ.V	Fitzroy Minerals Inc
FUND.V	Katipult Technology Corp
FUSE.V	Fuse Battery Metals Inc
FUU.V	F3 Uranium Corp
FV.H.V	Firestone Ventures Inc
FW.V	Flow Capital Corp
FWTC.V	Forward Water Technologies Corp
FWZ.V	Fireweed Metals Corp
FYL.V	Finlay Minerals Ltd
GAB.V	Gabo Mining Ltd.
GAL.V	Galantas Gold Corp
GAR.H.V	Green Arrow Resources Inc
GASX.V	Ng Energy Intl Corp
GBML.V	Global Battery Metals Ltd
GBRC.V	Gold Bull Resources Corp
GBU.V	Gabriel Res J
GCN.V	Goldcliff Resource Corp
GCOM.V	Green Shift Commodities Ltd
GCV.P.V	Golden Star Capital Ventures Inc
GCX.V	Granite Creek Copper Ltd
GDNP.H.V	Good Natured Products Inc.
GDP.V	Golden Pursuit Resources Ltd
GDX.V	Goldex Resources Corp
GEL.V	Graphano Energy Ltd
GEM.V	Green Battery Minerals Inc
GEMC.V	Global Energy Metals Corp
GEN.V	Generation Uranium Inc
GENI.V	Genius Metals Inc
GENX.V	Genix Pharmaceuticals Corp
GETT.V	G.E.T.T. Gold Inc
GFG.V	Gfg Resources Inc
GG.V	Golconda Gold Ltd
GGA.V	Goldgroup Mining Inc
GGG.V	G6 Materials Corp
GGI.V	Garibaldi Resources Corp
GGL.V	Ggl Resources Corp
GGM.V	Granada Gold Mine Inc
GGO.V	Galleon Gold Corp
GGX.V	Ggx Gold Corp
GHL.V	Goldhills Holding Ltd
GHML.V	Golden Horse Minerals Ltd
GHR.H.V	Golden Harp Resources Inc
GHRT.V	Greenheart Gold Inc
GIG.V	Xau Resources Inc
GIGA.V	Giga Metals Corp
GIII.V	Regen III Corp
GIP.V	Green Impact Partners Inc
GIT.V	Gitennes Exploration Inc
GKO.V	Geekco Technologies Corp
GLAD.V	Gladiator Metals Corp
GLB.V	Goldbank Mining Corp
GLD.V	Goldon Resources Ltd
GLDC.V	Cassiar Gold Corp
GLI.V	Glacier Lake Resources Inc
GMA.V	Geomega Resources Inc
GMG.V	Graphene Manufacturing Group Ltd
GMV.V	Gmv Minerals Inc
GNFI.V	Genifi Inc
GNG.V	Golden Goliath Resources Ltd
GOFL.V	Goldflare Exploration Inc
GOK.V	Ginsms Inc
GOOD.V	Good Gamer Entertainment Inc
GOP.H.V	Gourmet Ocean Products Inc
GOT.V	Goliath Resources Ltd
GPAC.V	Great Pacific Gold Corp
GPG.V	Grande Portage Resources Ltd
GPH.V	Graphite One Inc
GPM.V	Gpm Metals Inc
GPUS.V	Alset Ai Ventures Inc
GPV.V	Greenpower Motor Company Inc
GQ.V	Great Quest Gold Ltd
GQC.V	Goldquest Mining Corp
GR.V	Great Atlantic Resources Corp
GRAT.V	Gratomic Inc
GRB.V	Greenbriar Sustainable Living Inc
GRD.V	Grounded Lithium Corp
GRDM.V	Grid Metals Corp
GRF.V	Green Rise Foods Inc
GRG.V	Golden Arrow Res Corp
GRI.V	Galore Resources Inc
GRSL.V	Gr Silver Mining Ltd
GRVA.P.V	Grosvenor Cpc I Inc.
GRZ.V	Gold Reserve Ltd
GSD.V	Devonian Health Group Inc
GSHR.V	Goldshore Resources Inc
GSI.V	Gatekeeper Systems Inc
GSP.V	Gensource Potash Corp
GSPR.V	Gsp Resource Corp
GSS.V	Gossan Resources Ltd
GSTM.V	Goldstorm Metals Corp
GSVR.V	Guanajuato Silver CO Ltd
GT.V	GT Resources Inc.
GTC.V	Getty Copper Inc
GUF.V	Gulf & Pacific Equities Corp
GUG.V	Gungnir Resources Inc
GUN.V	Gunpoint Exploration Ltd
GUS.V	Angus Gold Inc
GWM.V	Galway Metals Inc
GX.V	Guardian Exploration Inc
GXU.V	Goviex Uranium Inc
GXX.V	Gold Basin Resources Corp
GXY.P.V	Galaxy Ventures Inc.
GZD.V	Grizzly Discoveries Inc
HAM.V	Highwood Asset Management Ltd
HAM.WT.V	Highwood Asset Management Ltd Wts
HAN.V	Hannan Metals Ltd
HANK.V	Nobelium Tech Corp
HANS.V	Hanstone Gold Corp
HAPB.V	Hapbee Technologies Inc
HAR.V	Harfang Exploration Inc
HASH.V	Simply Solventless Concentrates Ltd.
HAWK.V	Hawkeye Gold and Diamond Inc
HBK.V	Highbank Resources Ltd.
HC.V	Hypercharge Networks Corp.
HCC.H.V	Hanna Capital Corp
HCH.V	Hot Chili Limited
HCM.H.V	Highcliff Metals Corp
HCO.P.V	Hansco Capital Corp
HCU.V	Horizon Copper Corp.
HELI.V	First Helium Inc
HEM.V	Hemostemix Inc
HEMP.V	Hempalta Corp
HEVI.V	Helium Evolution Incorporated
HHH.V	Helius Minerals Ltd
HI.V	Highland Copper Company Inc
HILL.V	Hill Inc
HITI.V	High Tide Inc
HIVE.V	Hive Blockchain Technologies Inc
HMAN.V	Huntsman Exploration Inc
HMCC.P.V	High Mountain 2 Capital Corporation
HME.V	Hemisphere Energy Corp
HMR.V	Homerun Resources Inc
HO.P.V	H2 Ventures 1 Inc
HOH.V	High Arctic Overseas Holdings Corp
HPL.H.V	Horizon Petroleum Ltd
HPM.V	Halcones Precious Metals Corp
HPQ.V	Hpq Silicon Inc.
HPY.V	Happy Creek Minerals Ltd
HRE.H.V	Stans Energy Corp
HSTR.V	Heliostar Metals Ltd
HTC.V	Htc Purenergy Inc
HVG.V	Harvest Gold Corp
HWY.V	Highway 50 Gold Corp
HXC.H.V	Hfx Holding Corp
IB.V	Ibc Advanced Alloys Corp
IBAT.V	International Battery Metals Ltd
IBO.V	Universal Ibogaine Inc
ICM.V	Iconic Minerals Ltd
ICON.V	Intl Iconic Gold Exploration Corp.
ICRS.V	Icarus Capital Corp
ID.V	Identillect Technologies Corp
IDI.H.V	Indico Resources Ltd
IDL.V	Imaging Dynamics Company Ltd
IEI.V	Imperial Equities Inc
IFOS.V	Itafos
IFR.V	International Frontier Resources Corpora
IFX.V	Imaflex Inc
IGO.V	Independence Gold Corp
ILC.V	International Lithium Corp
ILI.V	Imagine Lithium Inc
IMC.V	Ibero Mining Corp
IMM.V	International Metals Mining Corp
IMPC.P.V	Impact Acquisitions Corp.
IMPT.V	Impact Development Group Inc.
IMR.V	Imetal Resources Inc
INEO.V	Ineo Tech Corp
INFD.V	Infield Minerals Corp
INFI.V	Infinitum Copper Corp
INFM.V	Infinico Metals Corp
INIK.V	Popreach Corporation
INSP.V	Inspire Semiconductor Holdings Inc
INTR.V	Intrepid Metals Corp
INX.V	Intouch Insight Ltd
ION.V	ION Energy Ltd
IOT.V	Innovotech Inc
IPT.V	Impact Silver Corp
IQ.V	Airiq Inc
IRI.V	Iemr Resources Inc
IRO.V	Inter-Rock Minerals Inc
ISGI.V	Insuraguest Technologies Inc
ITR.V	Integra Resources Corp
ITR.WT.V	Integra Resources Corp Wts
IVS.V	Inventus Mining Corp
IVX.V	Inventronics Ltd
IXI.V	Indigo Exploration Inc
IZ.V	International Zeolite Corp
IZN.V	Inzinc Mining Ltd
IZZ.V	International Prospect Ventures Ltd
JAB.P.V	Jabbo Capital Corp.
JADE.V	Jade Leader Corp
JAEG.H.V	Jaeger Resources Corp
JDN.V	Jayden Resources Inc
JEC.V	Jura Energy Corp
JES.P.V	Jesmond Capital Ltd.
JEV.V	Jericho Energy Ventures Inc
JG.V	Japan Gold Corp
JHC.V	Jinhua Capital Corporation
JJ.V	Jackpot Digital Inc
JPWR.H.V	Jade Power Trust
JRV.V	Jervois Mining Ltd
JTC.V	Jemtec Inc
JUGR.V	Juggernaut Exploration Ltd
JVR.P.V	Jvr Ventures Inc
JZR.V	Jzr Gold Inc
KALO.V	Kalo Gold Corp
KAPA.V	Kapa Gold Inc
KC.V	Kutcho Copper Corp
KCC.V	Kincora Copper Ltd
KDA.V	Kda Group Inc
KDK.V	Kodiak Copper Corp
KDSX.V	Kadestone Capital Corp
KEN.H.V	Kenadyr Metals Corp
KEON.H.V	Keon Capital Inc
KES.V	Kesselrun Resources Ltd
KFR.V	Kingfisher Metals Corp
KG.V	Klondike Gold Corp
KGC.V	Kestrel Gold Inc
KGL.H.V	Kgl Resources Ltd.
KGS.V	Kingsman Minerals Ltd
KIB.V	Kiboko Gold Inc
KIDZ.V	Kidoz Inc
KIP.V	Kiplin Metals Inc
KLD.V	Kenorland Minerals Ltd
KLDC.V	Kirkland Lake Discoveries Corp
KLE.H.V	Kingsland Energy Corp.
KLM.V	Kermode Resources Ltd
KLX.V	Klimat X Development Inc
KNC.V	K9 Gold Corp
KNE.V	Kane Biotech Inc
KNG.V	Kingsmen Resources Ltd
KORE.V	Kore Mining Ltd
KOVO.V	Kovo Healthtech Corp
KPEN.P.V	Kp3993 Resources Inc
KRI.V	Kobo Resources Inc
KRY.V	Koryx Copper Inc
KS.V	Klondike Silver Corp
KTN.V	Kootenay Silver Inc
KTO.V	K2 Gold Corp
KTR.V	Kintavar Exploration Inc
KTRI.V	Kootenay Resources Inc
KUAI.P.V	Kua Investments Inc
KUR.H.V	Kure Technologies Inc
KUT.V	Redishred Capital Corp
KWE.V	Kwesst Micro Systems Inc
KYS.H.V	Kaymus Resources Inc
LA.V	Los Andes Copper Ltd
LAB.V	Labrador Gold Corp
LBC.V	Libero Copper & Gold Corp
LBI.V	Lions Bay Capital Inc
LBNK.V	Lithiumbank Resources Corp
LBNK.WT.V	Lithiumbank Resources Corp
LCE.V	Century Lithium Corp
LCX.V	Lycos Energy Inc
LDB.P.V	Ldb Capital Corp
LEGY.V	Legacy Gold Mines Ltd
LEM.V	Leading Edge Materials Corp
LET.H.V	Letho Resources Corp
LEXI.V	Lithium Energi Exploration Inc
LFC.P.V	Left Field Capital Corp.
LFST.V	Lifeist Wellness Inc
LG.V	Lahontan Gold Corp
LGC.V	Lavras Gold Corp
LGN.V	Logan Energy Corp
LI.V	American Lithium Corp
LIFT.V	Li-Ft Power Ltd.
LILL.P.V	Little Fish Acquisition I Corp
LIO.V	Lion One Metals Ltd
LIO.WT.V	Lion One Metals Limited Wts
LIS.V	Lithium South Development Corp
LIT.V	Argentina Lithium and Energy Corp
LITH.V	Lithium Chile Inc
LITT.V	Right Season Investments Corp
LL.V	Canada Rare Earth Corp
LLG.V	Mason Resources Inc
LME.V	Laurion Mineral Exploration Inc
LMG.V	Lincoln Gold Mining Inc
LMN.V	Lumine Group Inc.
LMR.V	Lomiko Metals Inc
LMS.V	Latin Metals Inc
LNGE.V	Lng Energy Group Corp
LNGE.WT.V	Lng Energy Group Corp.
LOD.V	Lode Gold Resources Inc
LOG.P.V	Logica Ventures Corp
LONE.V	Lithium One Metals Inc
LORD.V	ST James Gold Corp
LOT.V	Tomagold Corp
LOU.V	Lucero Energy Corp
LOVE.V	Cannara Biotech Inc
LPC.V	Lorne Park Capital Partners Inc
LPK.V	Lupaka Gold Corp
LPS.V	Legend Power Systems Inc
LQWD.V	Lqwd Fintech Corp
LRA.V	Lara Exploration Ltd
LSD.H.V	Lightspeed Discoveries Inc
LSL.V	Lsl Pharma Group Inc
LSTR.V	Lodestar Metals Corp
LTH.V	Lithium Ionic Corp
LTX.V	Labrador Resources Inc
LUCA.V	Luca Mining Corp
LUM.V	Lumina Gold Corp
LVG.V	Lake Victoria Gold Ltd
LVX.V	Leviathan Gold Ltd
LWR.V	Lake Winn Resources Corp
MAC.V	Themac Resources Group Limited
MAE.V	Maritime Resources Corp
MAH.V	Marksmen Energy Inc
MAI.V	Minera Alamos Inc
MAND.P.V	Mandeville Ventures Inc
MAPS.V	Prostar Holdings Inc
MAR.UN.V	Marwest Apartment REIT
MARV.V	Marvel Discovery Corp
MAS.V	Mas Gold Corp
MASS.V	Masivo Silver Corp
MATE.V	Blockmate Ventures Inc
MAU.V	Montage Gold Corp
MAW.V	Mawson Gold Ltd
MAX.V	Max Resource Corp
MAZ.H.V	Mazarin Inc
MBI.H.V	Med Biogene Inc
MCF.V	Mcf Energy Ltd
MCM.A.V	Matachewan Cons Mines
MCS.V	Mcchip Resources Inc
MCT.P.V	M3 Capital Corp
MD.V	Midland Exploration Inc
MDCX.V	Medicus Pharma Ltd
MDM.V	Madoro Metals Corp
MDX.V	Medx Health Corp
MEEC.V	Midwest Energy Emissions Corp
MEGO.P.V	Amego Capital Corp
MEK.V	Metals Creek Resources Corp
MENE.V	Mene Inc
MERG.V	Metal Energy Corp
MET.V	Metalore Resources Ltd
MEX.V	Mexican Gold Mining Corp
MFA.P.V	Mayfair Acquisition Corporation
MFG.V	Mayfair Gold Corp
MFL.V	Mawson Finland Limited
MGG.V	Minaurum Gold Inc
MGI.V	Magnum Goldcorp Inc
MGM.V	Maple Gold Mines Ltd
MGRO.V	Mustgrow Biologics Corp
MHI.V	Mineral Hill Industries Ltd
MHUB.V	Minehub Technologies Inc
MILL.V	Millbank Mining Corp.
MIM.V	Mimedia Holdings Inc
MINE.V	Inomin Mines Inc
MINK.V	Mink Ventures Corporation
MIR.V	Medmira Inc
MIVO.V	Esstra Industries Inc
MJS.V	Majestic Gold Corp
MKA.V	Mkango Resources Ltd
MKO.V	Mako Mining Corp
MKR.V	Melkior Resources Inc
MKT.V	Deepmarkit Corp
MLO.V	Metalero Mining Corp
MLP.V	Millennial Potash Corp
MMA.V	Midnight Sun Mining Corp
MMG.V	Metallic Minerals Corp
MMM.V	Minco Capital Corp
MMN.V	Monarca Minerals Inc
MMS.V	Macarthur Minerals Ltd
MMY.V	Monument Mining Ltd
MN.V	Manganese X Energy Corp
MNLX.V	Miniluxe Holding Corp
MNRG.V	Monumental Energy Corp
MNX.V	Manitex Capital Inc
MOG.V	Mogotes Metals Inc
MON.V	Montero Mining and Exploration Ltd
MONA.P.V	Monarch West Ventures Inc
MONT.V	Montfort Capital Corp
MONT.PR.A.V	Timia Capital Corp Pref A
MOO.V	Moon River Moly Ltd
MOON.V	Blue Moon Metals Inc
MOX.V	Morien Resources Corp
MPH.V	Medicure Inc
MPTH.H.V	Mapath Capital Corp.
MQM.V	Metalquest Mining Inc
MRVL.V	Marvel Biosciences Corp
MRZ.V	Mirasol Resources Ltd
MSC.V	Millenium Silver Corp
MSP.V	Minaean SP Construction Corp
MSR.V	Minsud Resources Corp
MT.V	M3 Metals Corp.
MTA.V	Metalla Royalty & Streaming Ltd
MTB.V	Mtb Metals Corp
MTH.V	Mammoth Resources Corp
MTK.V	Montauk Metals Inc
MTLO.V	Martello Technologies Group Inc
MTS.V	Metallis Resources Inc
MTT.V	Magna Terra Minerals Inc
MTX.V	Metalex Ventures Ltd
MUN.V	Mundoro Capital Inc
MUR.V	Murchison Minerals Ltd
MUSH.V	The Good Shroom CO Inc
MUST.H.V	Must Capital Inc.
MVI.H.V	Monitor Ventures Inc
MVY.V	Moovly Media Inc
MXL.H.V	MX Gold Corp
MYID.V	Reklaim Ltd
NAM.V	New Age Metals Inc
NAR.V	North Arrow Minerals Inc
NAU.V	Nevgold Corp
NAV.V	Navco Pharmaceuticals Inc
NBLC.V	Nobel Resources Corp
NBM.V	NEO Battery Materials
NBR.V	Nubian Resources Ltd
NBVA.V	Nubeva Technologies Ltd
NBY.V	Niobay Metals Inc
NCAU.V	Newcore Gold Ltd
NCI.V	Ntg Clarity Networks Inc
NCX.V	Northisle Copper and Gold Inc
NDA.V	Neptune Digital Assets Corp
NED.V	New Destiny Mining Corp
NET.UN.V	Canadian Net Real Estate Investment Trust
NEV.V	Nevada Sunrise Metals Corp
NEW.H.V	New Target Mining Corp.
NEWO.V	Neworigin Gold Corp
NEWU.V	Newtopia Inc
NEXE.V	Nexe Innovations Inc
NEXG.V	Nexgold Mining Corp
NFD.A.V	Northfield Capital Corp. Cl.A Rv
NFG.V	New Found Gold Corp
NGC.V	Northern Graphite Corp
NGEN.V	Nervgen Pharma Corp
NGMD.V	Nugen Medical Devices Inc
NGY.V	Nexera Energy Inc
NHHH.V	Fuelpositive Corp
NHT.U.V	Nexpoint Hospitality Trust USD
NICK.V	Nickelex Resource Corporation
NICN.V	Nican Limited
NICU.V	Magna Mining Inc
NIKL.H.V	Gk Resources Ltd
NILI.V	Surge Battery Metals Inc
NIM.V	Nicola Mining Inc
NIO.V	Niocan Inc
NIR.H.V	Noble Iron Inc
NKG.V	Nevada King Gold Corp
NKL.V	Conic Metals Corp
NKW.H.V	Oceanic Wind Energy Inc
NL.V	Northern Lion Gold Corp
NLH.V	Nova Leap Health Corp
NLII.P.V	Nl2 Capital Inc
NMG.H.V	Noble Metal Group Incorporated
NMI.V	Namibia Critical Metals Inc
NNX.V	Nickel North Exploration Corp
NOAL.V	Noa Lithium Brines Inc
NOB.V	Noble Mineral Exploration Inc
NOCR.V	Norden Crown Metals Corp
NORR.V	Norrland Gold Corp
NOU.V	Nouveau Monde Graphite Inc
NOW.V	Nowvertical Group Inc
NPR.V	North Peak Resources Ltd
NPTH.V	Neupath Health Inc
NRC.V	Nations Royalty Corp
NRM.V	Noram Lithium Corp
NRN.V	Northern Shield Resources Inc
NRX.V	Nurexone Biologic Inc
NSCI.V	Nanalysis Scientific Corp
NSE.V	New Stratus Energy Inc
NSU.V	North Shore Uranium Ltd.
NTB.V	New Tymbal Resources Ltd
NTE.V	Network Media Group Inc
NTH.V	Nord Precious Metals Mining Inc
NTX.V	Neoterrex Minerals Inc
NUG.V	Nulegacy Gold Coporation
NURS.V	Hydreight Technologies Inc
NVN.P.V	Navion Capital II Inc
NVT.V	Nortec Minerals Corp
NVX.V	NV Gold Corp
NWST.V	Northwest Copper Corp
NWX.V	Newport Exloration Ltd
NXG.V	Nexgenrx Inc
NXH.V	Next Hydrogen Solutions Inc
NXLV.V	Nexliving Communities Inc
NXS.V	Nexus Gold Corp
NZ.V	New Zealand Energy Corp
NZP.V	Chatham Rock Phosphate Ltd
OAC.P.V	Oa Capital Corp.
OAM.V	Overactive Media Corp
OC.V	Olive Resource Capital Inc
OCG.V	Outcrop Silver & Gold Corp
OCI.V	Orecap Invest Corp
OCO.V	Oroco Resource Corp
ODD.V	Odd Burger Corp
ODV.V	Osisko Development Corp
ODV.WT.A.V	Osisko Development Corp Wts A
ODV.WT.B.V	Osisko Development Corp Wts B
ODV.WT.U.V	Osisko Development Corp Wts USD
ODX.H.V	Odyssey Resources Ltd
OEC.H.V	Oracle Energy Corp
OEG.H.V	Onenergy Inc
OGN.V	Orogen Royalties Inc
OIII.V	O3 Mining Inc
OKAI.V	Evokai Creative Labs Inc
OLV.V	Olivut Resources Ltd
OM.V	Osisko Metals Incorporated
OMG.V	Omai Gold Mines Corp
OMI.V	Orosur Mining Inc
OML.V	Omni-Lite Industries Canada Inc
OMM.V	Omineca Mining and Metals Ltd
OMM.RT.V	Omineca Mining and Metals Ltd RTS
ONAU.V	Ongold Resources Ltd
ONE.V	01 Communique Laboratory Inc
ONYX.V	Onyx Gold Corp
OOR.V	Opus One Gold Corp
OPHR.V	Ophir Metals Corp
OPTG.V	Optegra Ventures Inc
OPW.V	Opawica Explorations Inc
ORC.B.V	Orca Energy Group Inc Cl B
ORCL.V	Oracle Commodity Holding Corp
ORS.V	Orestone Mining Corp
OSIX.V	Oceansix Future Paths Ltd
OSS.V	Onesoft Solutions Inc
OTC.V	Ocumetics Technology Corp
OTGO.H.V	O2Gold Inc
OVL.H.V	Olivier Ventures Inc
OVT.V	Oculus Visiontech Inc
OWN.V	Rex Resources Corp
OYL.V	Cgx Energy Inc
OZ.V	Valkea Resources Corp
PA.V	Palamina Corp
PACE.V	Pace Metals Ltd
PALI.V	Palisades Goldcorp Ltd
PANO.P.V	Panorama Capital Corp
PAR.H.V	Parent Capital Corp
PAT.V	Patterson Metals Corp
PAV.H.V	Pacific Arc Resources Ltd
PBM.V	Pacific Bay Minerals Ltd
PBX.V	Powerband Solutions Inc
PCAA.P.V	PC 1 Corp
PCLO.V	Pharmacielo Ltd
PCP.P.V	Pender Street Capital Corp.
PCQ.V	Petrolympic Ltd
PCRX.V	Pharmacorp Rx Inc.
PE.V	Pure Energy Minerals Ltd
PEAK.V	Sun Peak Metals Corp
PEC.H.V	Peak Discovery Capital Ltd
PEGA.V	Pegasus Resources Inc
PEI.V	Prospera Energy Inc
PEMC.V	Pacific Empire Minerals Corp
PER.V	Peruvian Metals Corp
PERU.V	Chakana Copper Corp
PESO.V	Pesorama Inc
PEX.V	Pacific Ridge Exploration Ltd
PEZM.H.V	Pezm Gold Inc
PFC.V	Petrofrontier Corp
PGC.V	Plato Gold Corp
PGDC.V	Patagonia Gold Corp
PGE.V	Stillwater Critical Minerals
PGLD.V	P2 Gold Inc
PGP.V	Power Group Projects Corp
PGX.V	Prosper Gold Corp
PGZ.V	Pan Global Resources Inc
PHA.V	Premier Health of America Inc
PHD.V	Providence Gold Mines Inc
PHNM.V	Phenom Resources Corp
PINE.UN.V	Pine Trail Real Estate Investment Trust
PINK.V	Perimeter Medical Imaging Ai Inc
PINN.V	Pinnacle Silver and Gold Corp
PJX.V	Pjx Resources Inc
PKT.V	Parkit Enterprise Inc
PLA.V	Plata Latina Minerals Corp
PLAN.V	Progressive Planet Solutions Inc
PLO.H.V	Paloma Resources Inc.
PLRB.V	Pluribus Technologies Corp
PLSR.V	Pulsar Helium Inc.
PLUR.V	Plurilock Securityinc
PLXX.P.V	Planet X II Capital Corp
PLY.V	Playfair Mining Ltd
PML.V	Panoro Minerals Ltd
PMX.V	Proam Exploration Corp
PNG.V	Kraken Robotics Inc
PNN.V	Pambili Natural Resources Corp
PNPN.V	Power Nickel Inc
PNRL.V	Premium Nickel Resources Ltd
PNTR.V	Pantera Silver Corp
POC.P.V	Pocml 7 Inc.
POND.V	Pond Technologies Holdings Inc
POOL.V	Pool Safe Inc
POR.V	Portofino Resources Inc
PPM.V	Pacific Imperial Mines Inc
PPP.V	Prospector Metals Corp
PPX.V	Ppx Mining Corp
PRG.V	Precipitate Gold Corp
PRS.H.V	Prism Resources Inc.
PRSN.V	Personas Social Incorporated
PTE.V	Pioneering Technology Corp
PTEC.V	Principal Technologies Inc
PTF.V	Pender Growth Fund Inc
PTFY.V	Plantify Foods Inc
PTK.V	Poet Technologies Inc
PTP.H.V	Petrichor Energy Inc
PTU.V	Purepoint Uranium Group Inc
PUL.V	Pulse Oil Corp
PUMA.V	Puma Exploration Inc
PUR.V	Premier American Uranium Inc
PVF.PR.U.V	Partners Value Investments Series 1 Pref
PVF.PR.V.V	Partners Value Investments LP Pref
PVF.UN.V	Partners Value Investments LP
PVF.WT.V	Partners Value Investments WT
PVIS.V	Parvis Invest Inc
PVT.V	Pivotree Inc
PWM.V	Power Metals Corp
PWRO.V	Power One Resources Corp.
PX.V	Pelangio Exploration Inc
Q.V	Quetzal Copper Corp
QCCU.V	QC Copper and Gold Inc
QCX.V	Qcx Gold Corp
QGR.V	Q Gold Resources Ltd
QIS.V	Quorum Information Technologies Inc
QMC.V	Qmc Quantum Minerals Corp
QNC.V	Quantum Emotion Corp
QPM.V	Quebec Precious Metals Corp
QPT.V	Quest Pharmatech Inc
QRO.V	Quadro Resources Inc
QST.V	Questor Technology Inc
QTWO.V	Q2 Metals Corp
QUIS.V	Quisitive Technology Solutions Inc
QURI.V	Quri Mayu Developments Ltd
QYOU.V	Qyou Media Inc
QZM.V	Quartz Mountain Resources Ltd
RAGE.V	Renegade Gold Inc
RAK.V	Rackla Metals Inc
RAMP.V	Ramp Metals Inc
RARE.V	Tactical Resources Corp.
RBX.V	Robex Resources Inc
RBX.WT.V	Robex Resources Inc.
RBZ.V	Arya Resources Ltd
RCK.V	Rock Tech Lithium Inc
RCK.WT.V	Rock Tech Lithium Inc.
RCR.P.V	Canna 8 Investment Trust
RCT.V	Rochester Resources Ltd
RDG.V	Ridgeline Minerals Corp
RDS.V	Radisson Mining Resources Inc
RDU.V	Radius Gold Inc
RE.V	Re Royalties Ltd
REBL.P.V	Genesis Acquisition Corp.
REC.V	Record Resources Inc
RECO.V	Reconnaissance Energy Africa Ltd
RECO.WT.V	Reconnaissance Energy Africa Ltd Wts
REE.V	E Tech Resources Inc
REG.V	Regulus Resources Inc
REKO.V	Reko International Group Inc
RES.V	Auric Resources Corp
RET.V	Reitmans Canada
RET.A.V	Reitmans [Canada] Ltd Cl A NV
REVO.V	Revolugroup Canada Inc
REVV.V	Revolve Renewable Power Corp
REX.V	Orex Minerals Inc
REYG.V	Reyna Gold Corp
RG.V	Romios Gold Resources Inc
RGC.V	Relevant Gold Corp
RGI.V	Reco International Group Inc
RHC.V	Royal Helium Ltd
RHC.WT.A.V	Royal Helium Ltd.
RHC.WT.B.V	Royal Helium Ltd.
RIO.V	Rio2 Ltd
RIWI.V	Riwi Corp
RJX.A.V	Rjk Explorations Ltd Cl A Sv
RK.V	Rockhaven Resources Ltd
RKR.V	Rokmaster Resources Corp
RKV.V	Rakovina Therapeutics Inc
RLT.P.V	Railtown Capital Corp
RLYG.V	Riley Gold Corp
RMB.V	Rumbu Holdings Ltd
RMD.V	Richmond Minerals Inc
RMI.V	Ridgestone Mining Inc
RML.V	Rusoro Mining Ltd
RMO.V	Rainy Mountain Royalty Corp
RNCH.V	Melior Resources Inc
ROAR.V	Lion Rock Resources Inc
ROCK.V	Rockridge Resources Ltd
ROI.V	Route1 Inc
ROK.V	Rok Resources Inc
ROK.WT.V	Rok Resources Inc.
ROMJ.V	Rubicon Organics Inc
ROOF.V	Northstar Clean Technologies Inc
ROS.V	Roscan Gold Corp
ROVR.V	Rover Critical Minerals Corp
ROX.V	Canstar Resources Inc
RP.V	Replicel Life Sciences Inc
RPP.V	Regent Pacific Properties Inc
RPX.V	Red Pine Exploration Inc
RRCC.P.V	Raging Rhino Capital Corp
RRI.V	Riverside Resources Inc
RRL.V	Resolute Resources Ltd
RRL.H.V	Resolute Resources Ltd.
RRM.H.V	Ross River Minerals Inc
RRR.UN.V	R and R Real Estate Investment Trust
RSC.P.V	Rockmount Capital Corporation
RSLV.V	Reyna Silver Corp
RSM.V	Resouro Strategic Metals Inc
RSMX.V	Regency Silver Corp
RSS.V	Resaas Services Inc
RTE.V	Route 109 Resources Inc
RTM.V	Rt Minerals Corp
RUA.V	Rua Gold Inc.
RUG.V	Rugby Resources Ltd
RUM.V	Rocky Mountain Liquor Inc
RUN.H.V	Running Fox Resource Corp
RUSH.V	Carolina Rush Corp
RV.V	Discovery One Investment Corp
RVC.P.V	Ronin Ventures Corp
RVG.V	Revival Gold Inc
RVLY.V	Rivalry Corp
RW.V	Renoworks Software Inc
RX.V	Biosyent Inc
RYE.V	Rhyolite Resources Ltd
RYO.V	Rio Silver Inc
RYR.V	Royal Road Minerals Ltd
SA.H.V	Southern Arc Minerals Inc
SAE.V	Sable Resources Ltd
SAF.V	Seasif Exploration Inc
SAG.V	Sterling Metals Corp
SAGA.V	Saga Metals Corp
SAGE.V	Sage Potash Corp
SALT.V	Atlas Salt Inc
SAO.V	South Atlantic Gold Inc
SASK.V	Atha Energy Corp.
SAT.V	Asian Television Network Int Ltd
SATO.V	Canada Computational Unlimited Corp
SAY.V	Sparta Capital Ltd
SBBC.V	Simply Better Brands Corp
SBIO.V	Sabio Holdings Inc
SBM.V	Sirona Biochem Corp
SBMI.V	Silver Bullet Mines Corp
SBO.H.V	Schwabo Capital Corporation
SC.H.V	Serrano Resources Ltd
SCAN.V	Liberty Defense Holdings Ltd
SCD.V	Imperial Mining Group Ltd
SCLT.V	Searchlight Resources Inc
SCOT.V	Scottie Resources Corp
SCPT.A.V	Starlight US Multi Family 2 Core Plus Fd
SCZ.V	Santacruz Silver Mining Ltd
SDCU.V	Sonoran Desert Copper Corp
SDI.V	Stampede Drilling Inc
SDR.V	Stroud Resources Ltd
SECU.V	Ssc Security Services Corp
SEI.V	Sintana Energy Inc
SEND.V	Sendero Resources Corp
SEV.V	Spectra7 Microsystems Inc
SEVN.P.V	Seven Oaks Capital Corp
SFR.V	Sandfire Resources America Inc
SGC.V	Solstice Gold Corp
SGD.V	Snowline Gold Corp
SGE.V	Strategem Capital Corp
SGML.V	Sigma Lithium Corp
SGN.V	Scorpio Gold Corporation
SGO.V	Sonoro Gold Corp
SGQ.V	Southgobi Resources Ltd
SGU.V	Signature Resources Ltd
SGZ.V	Sego Resources Inc
SHL.V	Homeland Nickel Inc
SHLL.P.V	Shellron Capital Ltd
SIC.V	Sokoman Minerals Corp
SIE.V	Sienna Resources Inc
SIG.V	Sitka Gold Corp
SILV.V	Silver Valley Metals Corp
SIQ.H.V	Siq Mountain Industries Inc
SKP.V	Strikepoint Gold Inc
SKRR.V	Skrr Exploration Inc
SKYG.V	Sky Gold Corp
SLG.V	San Lorenzo Gold Corp
SLI.V	Standard Lithium Ltd
SLMN.V	Solis Minerals Ltd
SLVR.V	Silver Tiger Metals Inc
SM.V	Sierra Madre Gold and Silver Ltd
SMAR.P.V	Smartset Services Inc
SMD.V	Strategic Metals Ltd
SME.V	Sama Resources Inc Ressources Sama Inc
SMN.V	Sun Summit Minerals Corp
SMP.V	Southern Empire Resources Corp
SMR.H.V	Shine Minerals Corp
SMRV.V	Smooth Rock Ventures Corp
SN.H.V	Sennen Potash Corporation
SNAG.V	Silver North Resources Ltd
SNG.V	Silver Range Resources Ltd
SNI.PR.A.V	Sonor Investments Limited
SNM.V	Shamaran Petroleum Corp
SNV.V	Sonoro Energy Ltd
SOI.V	Sirios Resources Inc
SOLR.V	Solar Alliance Energy Inc
SOMA.V	Soma Gold Corp
SOO.P.V	Spectre Capital Corp
SOP.H.V	Soperior Fertilizer Corp
SOU.V	Southern Energy Corp
SPA.V	Spanish Mountain Gold Ltd
SPC.V	Spc Nickel Corp
SPD.V	Silver Predator Corp
SPI.V	Canadian Spirit Resources Inc
SPMC.V	South Pacific Metals Corp.
SPN.V	Snipp Interactive Inc.
SPOT.V	Earthlabs Inc
SPRQ.V	Sparq Systems Inc
SPSA.P.V	SP Strategic Acquisition Corp
SPX.V	Stellar Africagold Inc
SPZ.V	Superbuzz Inc
SR.V	Strategic Resources Inc
SRA.V	Stria Lithium Inc
SRC.V	Stakeholder Gold Corp
SRE.V	Saville Resources Inc
SRES.V	Sun Residential REIT
SRI.V	Sparton Resources Inc
SRL.V	Salazar Resources Ltd
SRQ.V	Srq Resources Inc
SRR.V	Source Rock Royalties Ltd
SSA.V	Spectra Products Inc
SSE.V	Silver Spruce Resources Inc
SSSS.P.V	Shooting Star Acquisition Corp
SSV.V	Southern Silver Exploration Corp
SSVR.V	Summa Silver Corp
SSX.V	Sleeping Giant Capital Corp
STA.V	Sanatana Resources Inc
STAK.P.V	Bigstack Opportunities I Inc
STE.V	Starr Peak Mining Ltd
STH.V	Stelmine Canada Ltd
STMP.V	Stamper Oil and Gas Corp
STND.V	Standard Uranium Ltd
STNG.V	Stinger Resources Inc
STR.H.V	Santa Rosa Resources Corp
STRM.V	Storm Exploration Inc
STRR.V	Star Royalties Ltd
STS.V	South Star Mining Corp
STU.V	Stuhini Exploration Ltd
STUD.V	Stallion Uranium Corp
STUV.V	Stuve Gold Corp
SUGR.V	Sucro Limited
SUI.V	Superior Mining International Corp
SUN.V	Stardust Solar Energy Inc
SUP.V	Northern Superior Resources Inc
SURF.A.V	Starlight US Residential Fund CAD
SURG.V	Surge Copper Corp
SUU.V	Strathmore Plus Uranium Corp
SVE.V	Silver One Resources Inc
SVG.V	Silver Grail Resources Ltd
SVP.H.V	Sceptre Ventures Inc
SVRS.V	Silver Storm Mining Ltd
SWA.V	Sarama Resources Ltd
SWAN.V	Black Swan Graphene Inc
SWLF.V	Silver Wolf Exploration Ltd
SXL.V	Slam Exploration Inc
SYG.V	Sylla Gold Corp
SYH.V	Skyharbour Resources Ltd
TAB.H.V	Tablas Ventures Corp
TAJ.V	Tajiri Resources Corp
TAO.V	Tag Oil Ltd
TAU.V	Thesis Gold Holdings Inc
TBIX.V	Trustbix Inc
TBK.V	Trailbreaker Resources Ltd
TBLL.V	Tombill Mines Ltd
TBRD.V	Thunderbird Entertainment Group Inc
TBX.V	Turmalina Metals Corp
TCG.P.V	Transcontinental Gold Corp
TCO.V	Transatlantic Mining Corp
TDG.V	Tdg Gold Corp
TEA.V	Tearlach Resources Ltd
TECT.V	Tectonic Metals Inc
TELO.V	Telo Genomics Corp
TES.V	Tesoro Minerals Corp
TG.V	Trifecta Gold Ltd
TGH.V	Tornado Global Hydrovacs Ltd
TGOL.V	Thunder Gold Corp
TGX.V	Tgx Energy & Resources Inc
THM.V	Thunder Mountain Gold Inc
THP.V	Totally Hip Technologies Inc
THRM.V	Therma Bright Inc
THX.V	Thor Explorations Ltd
TIDE.P.V	Intertidal Capital Corp
TIE.V	Coloured Ties Capital Inc
TIG.V	Triumph Gold Corp
TIL.V	Till Capital Corp
TIN.V	Tincorp Metals Inc
TINY.V	Tiny Ltd
TK.V	Tinka Resources Ltd
TKU.V	Tarku Resources Ltd
TLA.V	Titan Logix Corp
TLT.V	Theralase Technologies Inc
TLX.P.V	Torchlight Innovations Inc.
TM.V	Trigon Metals Inc
TMET.V	Torr Metals Inc.
TMG.V	Thermal Energy International Inc
TMS.H.V	Targeted Microwave Solutions Inc
TNO.H.V	Terreno Resources Corp
TNR.V	Tnr Gold Corp
TOH.V	Total Helium Ltd
TOI.V	Topicus.com Inc
TORC.V	Tinone Resources Inc
TORO.V	Pucara Gold Ltd
TORQ.V	Torq Resources Inc
TORR.V	Torrent Capital Ltd
TOTC.P.V	Totec Resources Ltd.
TPC.V	Tenth Avenue Petroleum Corp
TPL.V	Tethys Petroleum Ltd
TR.V	Troubadour Resources Inc
TRAN.V	Clean Energy Transition Inc
TRBC.V	Tribeca Resources Corporation
TRBE.V	Tribe Property Technologies Inc
TRO.V	Taranis Resources Inc
TRS.V	Tres-Or Resources Ltd
TRU.V	Tru Precious Metals Corp
TRV.P.V	Treviso Capital Corp.
TSD.V	Tsodilo Resources Ltd
TSG.V	Tristar Gold Inc
TSLV.V	Tier One Silver Inc
TTG.V	Trans Canada Gold Corp
TTGI.V	Turnium Technology Group Inc
TTI.V	Thiogenesis Therapeutics Corp
TTO.H.V	Atoro Capital Corp
TTS.V	Tintina Mines Ltd.
TTZ.V	Total Telcom Inc
TUD.V	Tudor Gold Corp
TUF.V	Honey Badger Silver Inc
TUK.V	Tuktu Resources Ltd
TUO.V	Teuton Resources Corp
TVC.H.V	Three Valley Copper Corp
TVI.V	Tvi Pacific Inc
TWO.V	T2 Metals Corp
TWR.V	Tower Resources Ltd
TWY.H.V	Twyford Ventures Inc
TZR.H.V	Terrace Energy Corp
UCU.V	Ucore Rare Metals Inc
UFC.V	Urbanfund Corp
UGD.V	Unigold Inc
UIG.V	Urban Infrastructure Group Inc
ULT.V	Ultra Lithium Inc
UNO.H.V	Northern Uranium Corp
URZ.V	Urz3 Energy Corp
USCU.V	US Copper Corp
USHA.V	Usha Resources Ltd
USS.V	Uniserve Communications Corp
VAND.V	Largo Physical Vanadium Corp
VAU.V	Viva Gold Corp
VAX.V	Vantex Resources Ltd.
VCI.V	Vitreous Glass Inc
VCT.V	Volt Carbon Technologies Inc
VCU.V	Vizsla Copper Corp
VCV.V	Vatic Ventures Corp
VDO.H.V	Nevado Resources Corp
VEC.H.V	Vanadian Energy Corp
VEIN.V	Pasofino Gold Ltd
VENZ.V	Venzee Technologies Inc
VERT.V	Vertical Explorations Inc
VG.V	Volcanic Gold Mines Inc
VGD.V	Visible Gold Mines Inc
VGN.V	Greencastle Res Ltd
VIO.V	Vior Inc
VIPR.V	Silver Viper Minerals Corp
VIS.V	Visionstate Corp
VIZ.V	Visionary Gold Corp
VLC.V	Velocity Minerals Ltd
VLI.V	Vision Lithium Inc
VLT.V	Volt Lithium Corp
VLV.V	Venerable Ventures Ltd.
VLX.V	Velox Energy Materials Inc
VM.V	Voyageur Pharmaceuticals Ltd
VMC.V	Vicinity Motor Corp
VML.V	Viscount Mining Corp
VMS.V	Vortex Metals Inc
VMXX.V	Solidusgold Inc.
VO.V	Valore Metals Corp
VPI.V	Vitality Products Inc
VPT.V	Ventripoint Diagnostics Ltd
VRB.V	Vanadiumcorp Resource Inc
VROY.V	Vizsla Royalties Corp
VROY.WT.V	Vizsla Royalties Corp Wts
VRR.V	Vr Resources Ltd
VRY.V	Petro Victory Energy Corp
VTEN.P.V	V Ten Capital Corp
VTT.V	Vendetta Mining Corp
VTX.V	Vertex Resource Group Ltd
VUL.V	Vulcan Minerals Inc
VUX.V	Vital Energy Inc
VVC.V	Vvc Exploration Corp
VXTR.V	Voxtur Analytics Corp
VZLA.V	Vizsla Resources Corp
VZZ.V	Val-D'Or Mining Corp
WAM.V	Western Alaska Minerals Corp
WAT.P.V	Whatcom Capital II Corp
WATR.V	Current Water Technologies Inc
WAVE.V	Waverley Pharma Inc
WBE.V	Westbond Enterprises Corp
WCE.V	Wescan Energy Corp
WCU.V	World Copper Ltd
WEB.V	Westbridge Renewable Energy Corp
WED.V	The Westaim Corp
WEX.V	Western Exploration Inc
WFLD.V	Wellfield Technologies Inc
WGF.V	Wescan Goldfields Inc
WGLD.V	Western Gold Exploration Ltd
WGO.V	White Gold Corp
WGT.V	Westgate Energy Inc
WHN.V	Westhaven Gold Corp
WHY.V	West High Yield Resources Ltd
WI.V	The Western Investment CO of Cda Ltd
WI.RT.V	The Western Investment CO of Cda Ltd RTS
WIL.V	Wilton Resources Inc
WINS.V	Winshear Gold Corp
WISH.V	Wishpond Technologies Ltd
WKG.V	Westkam Gold Corp
WLF.V	Wolfden Resources Corp
WMK.V	Whitemud Resources Inc
WML.V	Wealth Minerals Ltd
WMS.V	Western Metallica Resources Corp
WOLF.V	Grey Wolf Animal Health Corp
WOOD.P.V	Woodbridge Ventures II Inc
WP.V	Western Pacific Trust Company
WPR.V	Canpr Technology Ltd
WRI.V	Waseco Resources Inc
WRLG.V	West Red Lake Gold Mines Ltd
WRLG.NT.U.V	West Red Lake Gold Mines Ltd.
WRLG.WT.V	West Red Lake Gold Mines Ltd Wts
WRLG.WT.A.V	West Red Lake Gold Mines Ltd.
WRR.V	Walker River Resources Corp
WSK.V	Wildsky Resources Inc
WVM.V	West Vault Mining Inc
WWT.V	Water Ways Technologies Inc
XBOT.V	Tokens.com Corp
XCAP.P.V	Exelerate Capital Corp
XCYT.V	Xcyte Digital Corp.
XGC.V	Xali Gold Corp
XIM.V	Ximen Mining Corp
XL.V	Xxl Energy Corp.
XND.V	Xander Resources Inc
XOX.P.V	Planet X Capital Corp.
XPLR.V	Xplore Resources Corp
XRTX.V	Xortx Therapeutics Inc
XTM.V	Transition Metals Corp
XX.V	Avante Corp
YAK.V	Mongolia Growth Group Ltd
YAY.V	Ths Maple Holdings Ltd
YEG.V	Yorkton Equity Group Inc
YERB.U.V	Yerbae Brands Corp USD
YES.V	Char Technologies Ltd
YFI.V	Edgewater Wireless Systems Inc
YGT.V	Gold Terra Resource Corp
YNV.V	Ynvisible Interactive Inc
YOO.V	Yangaroo Inc
YORK.V	York Harbour Metals Inc.
YTY.V	Wi2Wi Corp
YVR.P.V	Badger Capital Corp
Z.H.V	Zinc One Resources Inc
ZAC.V	Zacatecas Silver Corp
ZAU.V	Zodiac Gold Inc
ZBNI.V	Zeb Nickel Corp.
ZC.V	Zimtu Capital Corp
ZCC.H.V	Zena Mining Corp
ZDC.V	Zedcor Inc
ZEN.V	Zentek Ltd
ZFR.V	Zephyr Minerals Ltd
ZLTO.V	Bulgold Inc
ZNC.H.V	Zincore Metals Inc
ZNG.V	Group Eleven Resources Corp
ZNX.V	Zincx Resources Corp
ZOMD.V	Zoomd Technologies Ltd
ZON.V	Zonte Metals Inc
ZONE.V	Zonetail Inc
ZUM.V	Zoomermedia Ltd
ZYUS.V	Zyus Life Sciences Corporation
